id,year,status,LEO,MEO,GEO,other,missing,total
AFWTR,1957,Inactive,0,0,0,0,0,0
AFWTR,1958,Inactive,0,0,0,0,0,0
AFWTR,1959,Active,6,0,0,0,0,6
AFWTR,1960,Active,6,0,0,0,0,6
AFWTR,1961,Active,13,2,0,0,0,15
AFWTR,1962,Active,29,1,0,0,1,31
AFWTR,1963,Active,23,2,0,0,0,25
AFWTR,1964,Active,34,0,0,0,0,34
AFWTR,1965,Active,33,2,0,0,0,35
AFWTR,1966,Active,38,5,0,0,0,43
AFWTR,1967,Active,33,1,0,1,0,35
AFWTR,1968,Active,28,2,0,0,0,30
AFWTR,1969,Active,20,1,0,1,0,22
AFWTR,1970,Active,17,0,0,0,0,17
AFWTR,1971,Active,15,0,0,0,2,17
AFWTR,1972,Active,18,0,0,1,0,19
AFWTR,1973,Active,9,0,0,0,1,10
AFWTR,1974,Active,11,1,0,1,0,13
AFWTR,1975,Active,9,0,0,1,2,12
AFWTR,1976,Active,8,1,0,0,4,13
AFWTR,1977,Active,4,1,0,0,2,7
AFWTR,1978,Active,8,4,0,0,2,14
AFWTR,1979,Active,5,0,0,0,1,6
AFWTR,1980,Active,3,2,0,0,2,7
AFWTR,1981,Active,4,1,0,0,2,7
AFWTR,1982,Active,4,0,0,0,1,5
AFWTR,1983,Active,5,1,0,1,4,11
AFWTR,1984,Active,3,2,0,0,5,10
AFWTR,1985,Active,2,1,0,0,1,4
AFWTR,1986,Active,2,0,0,0,1,3
AFWTR,1987,Active,2,0,0,0,3,5
AFWTR,1988,Active,5,0,0,0,2,7
AFWTR,1989,Active,1,0,0,0,1,2
AFWTR,1990,Active,3,0,0,0,1,4
AFWTR,1991,Active,3,0,0,0,3,6
AFWTR,1992,Active,2,0,0,0,2,4
AFWTR,1993,Active,2,0,0,0,1,3
AFWTR,1994,Active,4,0,0,1,2,7
AFWTR,1995,Active,2,0,0,0,2,4
AFWTR,1996,Active,3,1,0,1,3,8
AFWTR,1997,Active,7,0,0,0,2,9
AFWTR,1998,Active,6,0,0,0,2,8
AFWTR,1999,Active,6,0,0,0,2,8
AFWTR,2000,Active,4,0,0,1,2,7
AFWTR,2001,Active,2,0,0,0,2,4
AFWTR,2002,Active,3,0,0,0,0,3
AFWTR,2003,Active,2,0,0,0,2,4
AFWTR,2004,Active,3,0,0,0,0,3
AFWTR,2005,Active,2,0,0,0,2,4
AFWTR,2006,Active,2,0,0,0,3,5
AFWTR,2007,Active,3,0,0,0,0,3
AFWTR,2008,Active,3,0,0,0,1,4
AFWTR,2009,Active,3,0,0,0,2,5
AFWTR,2010,Active,1,0,0,0,2,3
AFWTR,2011,Active,2,0,0,0,3,5
AFWTR,2012,Active,0,0,0,0,2,2
AFWTR,2013,Active,2,0,0,0,2,4
AFWTR,2014,Active,2,0,0,0,2,4
AFWTR,2015,Active,1,0,0,0,1,2
AFWTR,2016,Active,2,0,0,0,1,3
AFWTR,2017,Active,7,0,0,0,2,9
AFETR,1957,Inactive,0,0,0,0,0,0
AFETR,1958,Active,4,1,0,0,2,7
AFETR,1959,Active,1,2,0,2,0,5
AFETR,1960,Active,9,0,0,1,0,10
AFETR,1961,Active,10,0,0,2,0,12
AFETR,1962,Active,12,2,0,5,0,19
AFETR,1963,Active,3,1,2,2,0,8
AFETR,1964,Active,4,1,1,7,0,13
AFETR,1965,Active,11,2,1,6,0,20
AFETR,1966,Active,18,2,1,7,1,29
AFETR,1967,Active,5,2,4,11,0,22
AFETR,1968,Active,5,1,1,6,1,14
AFETR,1969,Active,6,0,3,8,1,18
AFETR,1970,Active,0,1,4,2,3,10
AFETR,1971,Active,1,0,4,4,1,10
AFETR,1972,Active,1,0,3,4,2,10
AFETR,1973,Active,4,0,3,4,2,13
AFETR,1974,Active,0,1,7,1,0,9
AFETR,1975,Active,4,0,7,2,2,15
AFETR,1976,Active,0,0,11,1,1,13
AFETR,1977,Active,1,0,9,4,3,17
AFETR,1978,Active,1,0,10,4,3,18
AFETR,1979,Active,1,1,3,1,2,8
AFETR,1980,Active,1,0,4,0,1,6
AFETR,1981,Active,2,0,7,0,2,11
AFETR,1982,Active,3,0,9,0,1,13
AFETR,1983,Active,4,0,7,0,0,11
AFETR,1984,Active,6,0,2,1,3,12
AFETR,1985,Active,9,0,3,0,0,12
AFETR,1986,Active,2,0,0,0,1,3
AFETR,1987,Active,0,0,2,0,1,3
AFETR,1988,Active,3,0,0,0,1,4
AFETR,1989,Active,6,5,1,0,4,16
AFETR,1990,Active,8,6,7,0,2,23
AFETR,1991,Active,6,1,5,0,0,12
AFETR,1992,Active,9,6,5,2,2,24
AFETR,1993,Active,8,6,3,0,3,20
AFETR,1994,Active,7,1,5,1,5,19
AFETR,1995,Active,8,0,7,1,7,23
AFETR,1996,Active,8,3,7,3,3,24
AFETR,1997,Active,8,2,8,2,3,23
AFETR,1998,Active,7,0,6,3,4,20
AFETR,1999,Active,6,6,3,2,3,20
AFETR,2000,Active,6,4,5,0,4,19
AFETR,2001,Active,6,2,1,3,4,16
AFETR,2002,Active,5,0,6,1,1,13
AFETR,2003,Active,2,3,3,3,5,16
AFETR,2004,Active,2,3,5,0,3,13
AFETR,2005,Active,1,1,1,2,2,7
AFETR,2006,Active,3,2,2,2,1,10
AFETR,2007,Active,4,2,0,3,4,13
AFETR,2008,Active,5,1,1,0,0,7
AFETR,2009,Active,5,2,2,2,5,16
AFETR,2010,Active,5,1,2,0,3,11
AFETR,2011,Active,3,1,0,3,3,10
AFETR,2012,Active,2,2,0,0,6,10
AFETR,2013,Active,1,1,2,1,5,10
AFETR,2014,Active,3,5,4,0,4,16
AFETR,2015,Active,4,3,3,2,4,16
AFETR,2016,Active,3,1,7,1,5,17
AFETR,2017,Active,5,0,8,0,6,19
FRGUI,1957,Inactive,0,0,0,0,0,0
FRGUI,1958,Inactive,0,0,0,0,0,0
FRGUI,1959,Inactive,0,0,0,0,0,0
FRGUI,1960,Inactive,0,0,0,0,0,0
FRGUI,1961,Inactive,0,0,0,0,0,0
FRGUI,1962,Inactive,0,0,0,0,0,0
FRGUI,1963,Inactive,0,0,0,0,0,0
FRGUI,1964,Inactive,0,0,0,0,0,0
FRGUI,1965,Inactive,0,0,0,0,0,0
FRGUI,1966,Inactive,0,0,0,0,0,0
FRGUI,1967,Inactive,0,0,0,0,0,0
FRGUI,1968,Inactive,0,0,0,0,0,0
FRGUI,1969,Inactive,0,0,0,0,0,0
FRGUI,1970,Active,2,0,0,0,0,2
FRGUI,1971,Active,1,0,0,0,0,1
FRGUI,1972,Active,0,0,0,0,0,0
FRGUI,1973,Active,0,0,0,0,0,0
FRGUI,1974,Active,0,0,0,0,0,0
FRGUI,1975,Active,3,0,0,0,0,3
FRGUI,1976,Active,0,0,0,0,0,0
FRGUI,1977,Active,0,0,0,0,0,0
FRGUI,1978,Active,0,0,0,0,0,0
FRGUI,1979,Active,1,0,0,0,0,1
FRGUI,1980,Active,0,0,0,0,0,0
FRGUI,1981,Active,0,0,1,1,0,2
FRGUI,1982,Active,0,0,0,0,0,0
FRGUI,1983,Active,0,0,2,0,0,2
FRGUI,1984,Active,0,0,4,0,0,4
FRGUI,1985,Active,0,0,2,1,0,3
FRGUI,1986,Active,1,0,1,0,0,2
FRGUI,1987,Active,0,0,2,0,0,2
FRGUI,1988,Active,0,0,7,0,0,7
FRGUI,1989,Active,0,0,7,0,0,7
FRGUI,1990,Active,1,0,4,0,0,5
FRGUI,1991,Active,1,0,7,0,0,8
FRGUI,1992,Active,1,0,6,0,0,7
FRGUI,1993,Active,1,0,6,0,0,7
FRGUI,1994,Active,1,0,5,0,0,6
FRGUI,1995,Active,1,0,8,1,1,11
FRGUI,1996,Active,0,0,10,0,0,10
FRGUI,1997,Active,0,1,10,1,0,12
FRGUI,1998,Active,1,1,9,0,0,11
FRGUI,1999,Active,1,0,8,1,0,10
FRGUI,2000,Active,0,0,12,0,0,12
FRGUI,2001,Active,0,0,7,0,1,8
FRGUI,2002,Active,2,0,9,0,0,11
FRGUI,2003,Active,0,0,4,0,0,4
FRGUI,2004,Active,0,0,1,1,1,3
FRGUI,2005,Active,0,0,5,0,0,5
FRGUI,2006,Active,0,0,5,0,0,5
FRGUI,2007,Active,0,0,6,0,0,6
FRGUI,2008,Active,1,0,5,0,0,6
FRGUI,2009,Active,0,0,5,1,1,7
FRGUI,2010,Active,0,1,5,0,0,6
FRGUI,2011,Active,1,1,4,0,1,7
FRGUI,2012,Active,3,1,6,0,0,10
FRGUI,2013,Active,2,1,3,1,0,7
FRGUI,2014,Active,3,3,5,0,0,11
FRGUI,2015,Active,1,3,6,1,0,11
FRGUI,2016,Active,3,2,6,0,0,11
FRGUI,2017,Active,2,1,7,0,1,11
HGSTR,1957,Inactive,0,0,0,0,0,0
HGSTR,1958,Inactive,0,0,0,0,0,0
HGSTR,1959,Inactive,0,0,0,0,0,0
HGSTR,1960,Inactive,0,0,0,0,0,0
HGSTR,1961,Inactive,0,0,0,0,0,0
HGSTR,1962,Inactive,0,0,0,0,0,0
HGSTR,1963,Inactive,0,0,0,0,0,0
HGSTR,1964,Inactive,0,0,0,0,0,0
HGSTR,1965,Active,1,0,0,0,0,1
HGSTR,1966,Active,0,1,0,0,0,1
HGSTR,1967,Active,2,0,0,0,0,2
HGSTR,1968,Inactive,0,0,0,0,0,0
HGSTR,1969,Inactive,0,0,0,0,0,0
HGSTR,1970,Inactive,0,0,0,0,0,0
HGSTR,1971,Inactive,0,0,0,0,0,0
HGSTR,1972,Inactive,0,0,0,0,0,0
HGSTR,1973,Inactive,0,0,0,0,0,0
HGSTR,1974,Inactive,0,0,0,0,0,0
HGSTR,1975,Inactive,0,0,0,0,0,0
HGSTR,1976,Inactive,0,0,0,0,0,0
HGSTR,1977,Inactive,0,0,0,0,0,0
HGSTR,1978,Inactive,0,0,0,0,0,0
HGSTR,1979,Inactive,0,0,0,0,0,0
HGSTR,1980,Inactive,0,0,0,0,0,0
HGSTR,1981,Inactive,0,0,0,0,0,0
HGSTR,1982,Inactive,0,0,0,0,0,0
HGSTR,1983,Inactive,0,0,0,0,0,0
HGSTR,1984,Inactive,0,0,0,0,0,0
HGSTR,1985,Inactive,0,0,0,0,0,0
HGSTR,1986,Inactive,0,0,0,0,0,0
HGSTR,1987,Inactive,0,0,0,0,0,0
HGSTR,1988,Inactive,0,0,0,0,0,0
HGSTR,1989,Inactive,0,0,0,0,0,0
HGSTR,1990,Inactive,0,0,0,0,0,0
HGSTR,1991,Inactive,0,0,0,0,0,0
HGSTR,1992,Inactive,0,0,0,0,0,0
HGSTR,1993,Inactive,0,0,0,0,0,0
HGSTR,1994,Inactive,0,0,0,0,0,0
HGSTR,1995,Inactive,0,0,0,0,0,0
HGSTR,1996,Inactive,0,0,0,0,0,0
HGSTR,1997,Inactive,0,0,0,0,0,0
HGSTR,1998,Inactive,0,0,0,0,0,0
HGSTR,1999,Inactive,0,0,0,0,0,0
HGSTR,2000,Inactive,0,0,0,0,0,0
HGSTR,2001,Inactive,0,0,0,0,0,0
HGSTR,2002,Inactive,0,0,0,0,0,0
HGSTR,2003,Inactive,0,0,0,0,0,0
HGSTR,2004,Inactive,0,0,0,0,0,0
HGSTR,2005,Inactive,0,0,0,0,0,0
HGSTR,2006,Inactive,0,0,0,0,0,0
HGSTR,2007,Inactive,0,0,0,0,0,0
HGSTR,2008,Inactive,0,0,0,0,0,0
HGSTR,2009,Inactive,0,0,0,0,0,0
HGSTR,2010,Inactive,0,0,0,0,0,0
HGSTR,2011,Inactive,0,0,0,0,0,0
HGSTR,2012,Inactive,0,0,0,0,0,0
HGSTR,2013,Inactive,0,0,0,0,0,0
HGSTR,2014,Inactive,0,0,0,0,0,0
HGSTR,2015,Inactive,0,0,0,0,0,0
HGSTR,2016,Inactive,0,0,0,0,0,0
HGSTR,2017,Inactive,0,0,0,0,0,0
JSC,1957,Inactive,0,0,0,0,0,0
JSC,1958,Inactive,0,0,0,0,0,0
JSC,1959,Inactive,0,0,0,0,0,0
JSC,1960,Inactive,0,0,0,0,0,0
JSC,1961,Inactive,0,0,0,0,0,0
JSC,1962,Inactive,0,0,0,0,0,0
JSC,1963,Inactive,0,0,0,0,0,0
JSC,1964,Inactive,0,0,0,0,0,0
JSC,1965,Inactive,0,0,0,0,0,0
JSC,1966,Inactive,0,0,0,0,0,0
JSC,1967,Inactive,0,0,0,0,0,0
JSC,1968,Inactive,0,0,0,0,0,0
JSC,1969,Inactive,0,0,0,0,0,0
JSC,1970,Active,0,1,0,0,0,1
JSC,1971,Active,1,0,0,0,0,1
JSC,1972,Active,0,0,0,0,0,0
JSC,1973,Active,0,0,0,0,0,0
JSC,1974,Active,0,0,0,0,0,0
JSC,1975,Active,3,0,0,0,0,3
JSC,1976,Active,2,0,0,0,0,2
JSC,1977,Active,0,0,0,0,0,0
JSC,1978,Active,1,0,0,0,0,1
JSC,1979,Active,0,0,0,0,0,0
JSC,1980,Active,0,0,0,0,0,0
JSC,1981,Active,1,0,0,0,0,1
JSC,1982,Active,1,0,0,0,0,1
JSC,1983,Active,1,0,0,0,0,1
JSC,1984,Active,1,0,0,0,0,1
JSC,1985,Active,1,0,0,0,0,1
JSC,1986,Active,1,0,0,0,0,1
JSC,1987,Active,2,0,0,0,0,2
JSC,1988,Active,1,0,0,0,0,1
JSC,1989,Active,0,0,0,0,0,0
JSC,1990,Active,1,0,0,0,0,1
JSC,1991,Active,0,0,0,0,0,0
JSC,1992,Active,2,0,0,0,0,2
JSC,1993,Active,1,0,0,0,0,1
JSC,1994,Active,1,0,0,0,0,1
JSC,1995,Active,0,0,0,0,0,0
JSC,1996,Active,1,0,0,0,0,1
JSC,1997,Active,0,0,0,0,0,0
JSC,1998,Active,0,0,0,0,0,0
JSC,1999,Active,1,0,0,0,0,1
JSC,2000,Active,0,0,0,0,0,0
JSC,2001,Active,1,0,0,0,0,1
JSC,2002,Active,2,0,0,0,0,2
JSC,2003,Active,2,0,0,0,0,2
JSC,2004,Active,2,0,0,0,0,2
JSC,2005,Active,4,0,0,0,0,4
JSC,2006,Active,1,0,0,0,0,1
JSC,2007,Active,1,0,0,0,0,1
JSC,2008,Active,3,0,0,0,0,3
JSC,2009,Active,2,0,0,0,0,2
JSC,2010,Active,4,0,0,0,0,4
JSC,2011,Active,5,0,0,0,0,5
JSC,2012,Active,5,0,0,0,0,5
JSC,2013,Active,7,0,0,0,0,7
JSC,2014,Active,8,0,0,0,0,8
JSC,2015,Active,5,0,0,0,0,5
JSC,2016,Active,9,0,0,0,0,9
JSC,2017,Active,6,0,0,0,0,6
KODAK,1957,Inactive,0,0,0,0,0,0
KODAK,1958,Inactive,0,0,0,0,0,0
KODAK,1959,Inactive,0,0,0,0,0,0
KODAK,1960,Inactive,0,0,0,0,0,0
KODAK,1961,Inactive,0,0,0,0,0,0
KODAK,1962,Inactive,0,0,0,0,0,0
KODAK,1963,Inactive,0,0,0,0,0,0
KODAK,1964,Inactive,0,0,0,0,0,0
KODAK,1965,Inactive,0,0,0,0,0,0
KODAK,1966,Inactive,0,0,0,0,0,0
KODAK,1967,Inactive,0,0,0,0,0,0
KODAK,1968,Inactive,0,0,0,0,0,0
KODAK,1969,Inactive,0,0,0,0,0,0
KODAK,1970,Inactive,0,0,0,0,0,0
KODAK,1971,Inactive,0,0,0,0,0,0
KODAK,1972,Inactive,0,0,0,0,0,0
KODAK,1973,Inactive,0,0,0,0,0,0
KODAK,1974,Inactive,0,0,0,0,0,0
KODAK,1975,Inactive,0,0,0,0,0,0
KODAK,1976,Inactive,0,0,0,0,0,0
KODAK,1977,Inactive,0,0,0,0,0,0
KODAK,1978,Inactive,0,0,0,0,0,0
KODAK,1979,Inactive,0,0,0,0,0,0
KODAK,1980,Inactive,0,0,0,0,0,0
KODAK,1981,Inactive,0,0,0,0,0,0
KODAK,1982,Inactive,0,0,0,0,0,0
KODAK,1983,Inactive,0,0,0,0,0,0
KODAK,1984,Inactive,0,0,0,0,0,0
KODAK,1985,Inactive,0,0,0,0,0,0
KODAK,1986,Inactive,0,0,0,0,0,0
KODAK,1987,Inactive,0,0,0,0,0,0
KODAK,1988,Inactive,0,0,0,0,0,0
KODAK,1989,Inactive,0,0,0,0,0,0
KODAK,1990,Inactive,0,0,0,0,0,0
KODAK,1991,Inactive,0,0,0,0,0,0
KODAK,1992,Inactive,0,0,0,0,0,0
KODAK,1993,Inactive,0,0,0,0,0,0
KODAK,1994,Inactive,0,0,0,0,0,0
KODAK,1995,Inactive,0,0,0,0,0,0
KODAK,1996,Inactive,0,0,0,0,0,0
KODAK,1997,Inactive,0,0,0,0,0,0
KODAK,1998,Inactive,0,0,0,0,0,0
KODAK,1999,Inactive,0,0,0,0,0,0
KODAK,2000,Inactive,0,0,0,0,0,0
KODAK,2001,Inactive,0,0,0,0,0,0
KODAK,2002,Inactive,0,0,0,0,0,0
KODAK,2003,Inactive,0,0,0,0,0,0
KODAK,2004,Inactive,0,0,0,0,0,0
KODAK,2005,Inactive,0,0,0,0,0,0
KODAK,2006,Inactive,0,0,0,0,0,0
KODAK,2007,Inactive,0,0,0,0,0,0
KODAK,2008,Inactive,0,0,0,0,0,0
KODAK,2009,Inactive,0,0,0,0,0,0
KODAK,2010,Active,0,0,0,0,1,1
KODAK,2011,Active,0,1,0,0,0,1
KODAK,2012,Inactive,0,0,0,0,0,0
KODAK,2013,Inactive,0,0,0,0,0,0
KODAK,2014,Inactive,0,0,0,0,0,0
KODAK,2015,Inactive,0,0,0,0,0,0
KODAK,2016,Inactive,0,0,0,0,0,0
KODAK,2017,Inactive,0,0,0,0,0,0
KSCUT,1957,Inactive,0,0,0,0,0,0
KSCUT,1958,Inactive,0,0,0,0,0,0
KSCUT,1959,Inactive,0,0,0,0,0,0
KSCUT,1960,Inactive,0,0,0,0,0,0
KSCUT,1961,Inactive,0,0,0,0,0,0
KSCUT,1962,Inactive,0,0,0,0,0,0
KSCUT,1963,Inactive,0,0,0,0,0,0
KSCUT,1964,Inactive,0,0,0,0,0,0
KSCUT,1965,Inactive,0,0,0,0,0,0
KSCUT,1966,Inactive,0,0,0,0,0,0
KSCUT,1967,Inactive,0,0,0,0,0,0
KSCUT,1968,Inactive,0,0,0,0,0,0
KSCUT,1969,Inactive,0,0,0,0,0,0
KSCUT,1970,Active,1,0,0,0,0,1
KSCUT,1971,Active,2,0,0,0,0,2
KSCUT,1972,Active,1,0,0,0,0,1
KSCUT,1973,Active,0,0,0,0,0,0
KSCUT,1974,Active,1,0,0,0,0,1
KSCUT,1975,Active,1,0,0,0,0,1
KSCUT,1976,Active,0,0,0,0,0,0
KSCUT,1977,Active,0,1,0,0,0,1
KSCUT,1978,Active,1,1,0,0,0,2
KSCUT,1979,Active,1,0,0,0,0,1
KSCUT,1980,Active,1,0,0,0,0,1
KSCUT,1981,Active,1,0,0,0,0,1
KSCUT,1982,Active,0,0,0,0,0,0
KSCUT,1983,Active,1,0,0,0,0,1
KSCUT,1984,Active,1,0,0,0,0,1
KSCUT,1985,Active,0,0,0,2,0,2
KSCUT,1986,Active,0,0,0,0,0,0
KSCUT,1987,Active,1,0,0,0,0,1
KSCUT,1988,Active,0,0,0,0,0,0
KSCUT,1989,Active,0,1,0,0,0,1
KSCUT,1990,Active,0,0,0,1,0,1
KSCUT,1991,Active,1,0,0,0,0,1
KSCUT,1992,Active,0,0,0,0,0,0
KSCUT,1993,Active,1,0,0,0,0,1
KSCUT,1994,Active,0,0,0,0,0,0
KSCUT,1995,Active,0,0,0,0,0,0
KSCUT,1996,Active,0,0,0,0,0,0
KSCUT,1997,Active,0,1,0,0,0,1
KSCUT,1998,Active,0,0,0,1,0,1
KSCUT,1999,Active,0,0,0,0,0,0
KSCUT,2000,Active,0,0,0,0,0,0
KSCUT,2001,Active,0,0,0,0,0,0
KSCUT,2002,Active,0,0,0,0,0,0
KSCUT,2003,Active,0,0,0,1,0,1
KSCUT,2004,Active,0,0,0,0,0,0
KSCUT,2005,Active,1,0,0,0,0,1
KSCUT,2006,Active,2,0,0,0,0,2
KSCUT,2007,Active,0,0,0,0,0,0
KSCUT,2008,Active,0,0,0,0,0,0
KSCUT,2009,Active,0,0,0,0,0,0
KSCUT,2010,Active,0,0,0,0,0,0
KSCUT,2011,Active,0,0,0,0,0,0
KSCUT,2012,Active,0,0,0,0,0,0
KSCUT,2013,Active,1,0,0,0,0,1
KSCUT,2014,Active,0,0,0,0,0,0
KSCUT,2015,Active,0,0,0,0,0,0
KSCUT,2016,Active,0,1,0,0,0,1
KSCUT,2017,Active,0,0,0,0,0,0
KWAJL,1957,Inactive,0,0,0,0,0,0
KWAJL,1958,Inactive,0,0,0,0,0,0
KWAJL,1959,Inactive,0,0,0,0,0,0
KWAJL,1960,Inactive,0,0,0,0,0,0
KWAJL,1961,Inactive,0,0,0,0,0,0
KWAJL,1962,Inactive,0,0,0,0,0,0
KWAJL,1963,Inactive,0,0,0,0,0,0
KWAJL,1964,Inactive,0,0,0,0,0,0
KWAJL,1965,Inactive,0,0,0,0,0,0
KWAJL,1966,Inactive,0,0,0,0,0,0
KWAJL,1967,Inactive,0,0,0,0,0,0
KWAJL,1968,Inactive,0,0,0,0,0,0
KWAJL,1969,Inactive,0,0,0,0,0,0
KWAJL,1970,Inactive,0,0,0,0,0,0
KWAJL,1971,Inactive,0,0,0,0,0,0
KWAJL,1972,Inactive,0,0,0,0,0,0
KWAJL,1973,Inactive,0,0,0,0,0,0
KWAJL,1974,Inactive,0,0,0,0,0,0
KWAJL,1975,Inactive,0,0,0,0,0,0
KWAJL,1976,Inactive,0,0,0,0,0,0
KWAJL,1977,Inactive,0,0,0,0,0,0
KWAJL,1978,Inactive,0,0,0,0,0,0
KWAJL,1979,Inactive,0,0,0,0,0,0
KWAJL,1980,Inactive,0,0,0,0,0,0
KWAJL,1981,Inactive,0,0,0,0,0,0
KWAJL,1982,Inactive,0,0,0,0,0,0
KWAJL,1983,Inactive,0,0,0,0,0,0
KWAJL,1984,Inactive,0,0,0,0,0,0
KWAJL,1985,Inactive,0,0,0,0,0,0
KWAJL,1986,Inactive,0,0,0,0,0,0
KWAJL,1987,Inactive,0,0,0,0,0,0
KWAJL,1988,Inactive,0,0,0,0,0,0
KWAJL,1989,Inactive,0,0,0,0,0,0
KWAJL,1990,Inactive,0,0,0,0,0,0
KWAJL,1991,Inactive,0,0,0,0,0,0
KWAJL,1992,Inactive,0,0,0,0,0,0
KWAJL,1993,Inactive,0,0,0,0,0,0
KWAJL,1994,Inactive,0,0,0,0,0,0
KWAJL,1995,Inactive,0,0,0,0,0,0
KWAJL,1996,Inactive,0,0,0,0,0,0
KWAJL,1997,Inactive,0,0,0,0,0,0
KWAJL,1998,Inactive,0,0,0,0,0,0
KWAJL,1999,Inactive,0,0,0,0,0,0
KWAJL,2000,Active,1,0,0,0,0,1
KWAJL,2001,Active,0,0,0,0,0,0
KWAJL,2002,Active,0,0,0,0,0,0
KWAJL,2003,Active,0,0,0,0,0,0
KWAJL,2004,Active,0,0,0,0,0,0
KWAJL,2005,Active,0,0,0,0,0,0
KWAJL,2006,Active,0,0,0,0,0,0
KWAJL,2007,Active,0,0,0,0,0,0
KWAJL,2008,Active,1,0,0,0,0,1
KWAJL,2009,Active,1,0,0,0,0,1
KWAJL,2010,Active,0,0,0,0,0,0
KWAJL,2011,Active,0,0,0,0,0,0
KWAJL,2012,Active,1,0,0,0,0,1
KWAJL,2013,Active,0,0,0,0,0,0
KWAJL,2014,Active,0,0,0,0,0,0
KWAJL,2015,Active,0,0,0,0,0,0
KWAJL,2016,Active,0,0,0,0,0,0
KWAJL,2017,Active,0,0,0,0,0,0
KYMTR,1957,Inactive,0,0,0,0,0,0
KYMTR,1958,Inactive,0,0,0,0,0,0
KYMTR,1959,Inactive,0,0,0,0,0,0
KYMTR,1960,Inactive,0,0,0,0,0,0
KYMTR,1961,Inactive,0,0,0,0,0,0
KYMTR,1962,Active,6,0,0,0,0,6
KYMTR,1963,Active,4,0,0,0,0,4
KYMTR,1964,Active,7,0,0,0,0,7
KYMTR,1965,Active,7,0,0,0,0,7
KYMTR,1966,Active,7,0,0,0,0,7
KYMTR,1967,Active,7,0,0,0,0,7
KYMTR,1968,Active,8,0,0,0,0,8
KYMTR,1969,Active,4,0,0,0,0,4
KYMTR,1970,Active,5,0,0,0,0,5
KYMTR,1971,Active,1,0,0,0,0,1
KYMTR,1972,Active,2,0,0,0,0,2
KYMTR,1973,Active,2,0,0,0,0,2
KYMTR,1974,Active,1,0,0,0,0,1
KYMTR,1975,Active,1,0,0,0,0,1
KYMTR,1976,Active,1,0,0,0,0,1
KYMTR,1977,Active,2,0,0,0,0,2
KYMTR,1978,Active,1,0,0,0,0,1
KYMTR,1979,Active,2,0,0,0,0,2
KYMTR,1980,Active,1,0,0,0,0,1
KYMTR,1981,Active,1,0,0,0,0,1
KYMTR,1982,Active,4,0,0,0,0,4
KYMTR,1983,Active,4,0,0,0,0,4
KYMTR,1984,Active,2,0,0,0,0,2
KYMTR,1985,Active,1,0,0,0,0,1
KYMTR,1986,Active,0,0,0,0,0,0
KYMTR,1987,Active,1,0,0,0,0,1
KYMTR,1988,Active,0,0,0,0,0,0
KYMTR,1989,Active,0,0,0,0,0,0
KYMTR,1990,Active,0,0,0,0,0,0
KYMTR,1991,Active,0,0,0,0,0,0
KYMTR,1992,Active,0,0,0,0,0,0
KYMTR,1993,Active,0,0,0,0,0,0
KYMTR,1994,Active,0,0,0,0,0,0
KYMTR,1995,Active,0,0,0,0,0,0
KYMTR,1996,Active,0,0,0,0,0,0
KYMTR,1997,Active,0,0,0,0,0,0
KYMTR,1998,Active,0,0,0,0,0,0
KYMTR,1999,Active,1,0,0,0,0,1
KYMTR,2000,Active,0,0,0,0,0,0
KYMTR,2001,Active,0,0,0,0,0,0
KYMTR,2002,Active,0,0,0,0,0,0
KYMTR,2003,Active,0,0,0,0,0,0
KYMTR,2004,Active,0,0,0,0,0,0
KYMTR,2005,Active,0,0,0,0,0,0
KYMTR,2006,Active,0,0,0,0,0,0
KYMTR,2007,Active,0,0,0,0,0,0
KYMTR,2008,Active,1,0,0,0,0,1
KYMTR,2009,Active,0,0,0,0,0,0
KYMTR,2010,Active,0,0,0,0,0,0
KYMTR,2011,Active,0,0,0,0,0,0
KYMTR,2012,Active,0,0,0,0,0,0
KYMTR,2013,Active,0,0,0,0,0,0
KYMTR,2014,Active,0,0,0,0,0,0
KYMTR,2015,Active,0,0,0,0,0,0
KYMTR,2016,Active,0,0,0,0,0,0
KYMTR,2017,Active,0,0,0,0,0,0
ALCAN,1957,Inactive,0,0,0,0,0,0
ALCAN,1958,Inactive,0,0,0,0,0,0
ALCAN,1959,Inactive,0,0,0,0,0,0
ALCAN,1960,Inactive,0,0,0,0,0,0
ALCAN,1961,Inactive,0,0,0,0,0,0
ALCAN,1962,Inactive,0,0,0,0,0,0
ALCAN,1963,Inactive,0,0,0,0,0,0
ALCAN,1964,Inactive,0,0,0,0,0,0
ALCAN,1965,Inactive,0,0,0,0,0,0
ALCAN,1966,Inactive,0,0,0,0,0,0
ALCAN,1967,Inactive,0,0,0,0,0,0
ALCAN,1968,Inactive,0,0,0,0,0,0
ALCAN,1969,Inactive,0,0,0,0,0,0
ALCAN,1970,Inactive,0,0,0,0,0,0
ALCAN,1971,Inactive,0,0,0,0,0,0
ALCAN,1972,Inactive,0,0,0,0,0,0
ALCAN,1973,Inactive,0,0,0,0,0,0
ALCAN,1974,Inactive,0,0,0,0,0,0
ALCAN,1975,Inactive,0,0,0,0,0,0
ALCAN,1976,Inactive,0,0,0,0,0,0
ALCAN,1977,Inactive,0,0,0,0,0,0
ALCAN,1978,Inactive,0,0,0,0,0,0
ALCAN,1979,Inactive,0,0,0,0,0,0
ALCAN,1980,Inactive,0,0,0,0,0,0
ALCAN,1981,Inactive,0,0,0,0,0,0
ALCAN,1982,Inactive,0,0,0,0,0,0
ALCAN,1983,Inactive,0,0,0,0,0,0
ALCAN,1984,Inactive,0,0,0,0,0,0
ALCAN,1985,Inactive,0,0,0,0,0,0
ALCAN,1986,Inactive,0,0,0,0,0,0
ALCAN,1987,Inactive,0,0,0,0,0,0
ALCAN,1988,Inactive,0,0,0,0,0,0
ALCAN,1989,Inactive,0,0,0,0,0,0
ALCAN,1990,Inactive,0,0,0,0,0,0
ALCAN,1991,Inactive,0,0,0,0,0,0
ALCAN,1992,Inactive,0,0,0,0,0,0
ALCAN,1993,Inactive,0,0,0,0,0,0
ALCAN,1994,Inactive,0,0,0,0,0,0
ALCAN,1995,Inactive,0,0,0,0,0,0
ALCAN,1996,Inactive,0,0,0,0,0,0
ALCAN,1997,Inactive,0,0,0,0,0,0
ALCAN,1998,Inactive,0,0,0,0,0,0
ALCAN,1999,Inactive,0,0,0,0,0,0
ALCAN,2000,Inactive,0,0,0,0,0,0
ALCAN,2001,Inactive,0,0,0,0,0,0
ALCAN,2002,Inactive,0,0,0,0,0,0
ALCAN,2003,Inactive,0,0,0,0,0,0
ALCAN,2004,Inactive,0,0,0,0,0,0
ALCAN,2005,Inactive,0,0,0,0,0,0
ALCAN,2006,Inactive,0,0,0,0,0,0
ALCAN,2007,Inactive,0,0,0,0,0,0
ALCAN,2008,Inactive,0,0,0,0,0,0
ALCAN,2009,Inactive,0,0,0,0,0,0
ALCAN,2010,Inactive,0,0,0,0,0,0
ALCAN,2011,Inactive,0,0,0,0,0,0
ALCAN,2012,Inactive,0,0,0,0,0,0
ALCAN,2013,Inactive,0,0,0,0,0,0
ALCAN,2014,Inactive,0,0,0,0,0,0
ALCAN,2015,Inactive,0,0,0,0,0,0
ALCAN,2016,Inactive,0,0,0,0,0,0
ALCAN,2017,Inactive,0,0,0,0,0,0
MUSUD,1957,Inactive,0,0,0,0,0,0
MUSUD,1958,Inactive,0,0,0,0,0,0
MUSUD,1959,Inactive,0,0,0,0,0,0
MUSUD,1960,Inactive,0,0,0,0,0,0
MUSUD,1961,Inactive,0,0,0,0,0,0
MUSUD,1962,Inactive,0,0,0,0,0,0
MUSUD,1963,Inactive,0,0,0,0,0,0
MUSUD,1964,Inactive,0,0,0,0,0,0
MUSUD,1965,Inactive,0,0,0,0,0,0
MUSUD,1966,Inactive,0,0,0,0,0,0
MUSUD,1967,Inactive,0,0,0,0,0,0
MUSUD,1968,Inactive,0,0,0,0,0,0
MUSUD,1969,Inactive,0,0,0,0,0,0
MUSUD,1970,Inactive,0,0,0,0,0,0
MUSUD,1971,Inactive,0,0,0,0,0,0
MUSUD,1972,Inactive,0,0,0,0,0,0
MUSUD,1973,Inactive,0,0,0,0,0,0
MUSUD,1974,Inactive,0,0,0,0,0,0
MUSUD,1975,Inactive,0,0,0,0,0,0
MUSUD,1976,Inactive,0,0,0,0,0,0
MUSUD,1977,Inactive,0,0,0,0,0,0
MUSUD,1978,Inactive,0,0,0,0,0,0
MUSUD,1979,Inactive,0,0,0,0,0,0
MUSUD,1980,Inactive,0,0,0,0,0,0
MUSUD,1981,Inactive,0,0,0,0,0,0
MUSUD,1982,Inactive,0,0,0,0,0,0
MUSUD,1983,Inactive,0,0,0,0,0,0
MUSUD,1984,Inactive,0,0,0,0,0,0
MUSUD,1985,Inactive,0,0,0,0,0,0
MUSUD,1986,Inactive,0,0,0,0,0,0
MUSUD,1987,Inactive,0,0,0,0,0,0
MUSUD,1988,Inactive,0,0,0,0,0,0
MUSUD,1989,Inactive,0,0,0,0,0,0
MUSUD,1990,Inactive,0,0,0,0,0,0
MUSUD,1991,Inactive,0,0,0,0,0,0
MUSUD,1992,Inactive,0,0,0,0,0,0
MUSUD,1993,Inactive,0,0,0,0,0,0
MUSUD,1994,Inactive,0,0,0,0,0,0
MUSUD,1995,Inactive,0,0,0,0,0,0
MUSUD,1996,Inactive,0,0,0,0,0,0
MUSUD,1997,Inactive,0,0,0,0,0,0
MUSUD,1998,Inactive,0,0,0,0,0,0
MUSUD,1999,Inactive,0,0,0,0,0,0
MUSUD,2000,Inactive,0,0,0,0,0,0
MUSUD,2001,Inactive,0,0,0,0,0,0
MUSUD,2002,Inactive,0,0,0,0,0,0
MUSUD,2003,Inactive,0,0,0,0,0,0
MUSUD,2004,Inactive,0,0,0,0,0,0
MUSUD,2005,Inactive,0,0,0,0,0,0
MUSUD,2006,Inactive,0,0,0,0,0,0
MUSUD,2007,Inactive,0,0,0,0,0,0
MUSUD,2008,Inactive,0,0,0,0,0,0
MUSUD,2009,Inactive,0,0,0,0,0,0
MUSUD,2010,Inactive,0,0,0,0,0,0
MUSUD,2011,Inactive,0,0,0,0,0,0
MUSUD,2012,Inactive,0,0,0,0,0,0
MUSUD,2013,Inactive,0,0,0,0,0,0
MUSUD,2014,Inactive,0,0,0,0,0,0
MUSUD,2015,Inactive,0,0,0,0,0,0
MUSUD,2016,Inactive,0,0,0,0,0,0
MUSUD,2017,Inactive,0,0,0,0,0,0
NSC,1957,Inactive,0,0,0,0,0,0
NSC,1958,Inactive,0,0,0,0,0,0
NSC,1959,Inactive,0,0,0,0,0,0
NSC,1960,Inactive,0,0,0,0,0,0
NSC,1961,Inactive,0,0,0,0,0,0
NSC,1962,Inactive,0,0,0,0,0,0
NSC,1963,Inactive,0,0,0,0,0,0
NSC,1964,Inactive,0,0,0,0,0,0
NSC,1965,Inactive,0,0,0,0,0,0
NSC,1966,Inactive,0,0,0,0,0,0
NSC,1967,Inactive,0,0,0,0,0,0
NSC,1968,Inactive,0,0,0,0,0,0
NSC,1969,Inactive,0,0,0,0,0,0
NSC,1970,Inactive,0,0,0,0,0,0
NSC,1971,Inactive,0,0,0,0,0,0
NSC,1972,Inactive,0,0,0,0,0,0
NSC,1973,Inactive,0,0,0,0,0,0
NSC,1974,Inactive,0,0,0,0,0,0
NSC,1975,Inactive,0,0,0,0,0,0
NSC,1976,Inactive,0,0,0,0,0,0
NSC,1977,Inactive,0,0,0,0,0,0
NSC,1978,Inactive,0,0,0,0,0,0
NSC,1979,Inactive,0,0,0,0,0,0
NSC,1980,Inactive,0,0,0,0,0,0
NSC,1981,Inactive,0,0,0,0,0,0
NSC,1982,Inactive,0,0,0,0,0,0
NSC,1983,Inactive,0,0,0,0,0,0
NSC,1984,Inactive,0,0,0,0,0,0
NSC,1985,Inactive,0,0,0,0,0,0
NSC,1986,Inactive,0,0,0,0,0,0
NSC,1987,Inactive,0,0,0,0,0,0
NSC,1988,Inactive,0,0,0,0,0,0
NSC,1989,Inactive,0,0,0,0,0,0
NSC,1990,Inactive,0,0,0,0,0,0
NSC,1991,Inactive,0,0,0,0,0,0
NSC,1992,Inactive,0,0,0,0,0,0
NSC,1993,Inactive,0,0,0,0,0,0
NSC,1994,Inactive,0,0,0,0,0,0
NSC,1995,Inactive,0,0,0,0,0,0
NSC,1996,Inactive,0,0,0,0,0,0
NSC,1997,Inactive,0,0,0,0,0,0
NSC,1998,Inactive,0,0,0,0,0,0
NSC,1999,Inactive,0,0,0,0,0,0
NSC,2000,Inactive,0,0,0,0,0,0
NSC,2001,Inactive,0,0,0,0,0,0
NSC,2002,Inactive,0,0,0,0,0,0
NSC,2003,Inactive,0,0,0,0,0,0
NSC,2004,Inactive,0,0,0,0,0,0
NSC,2005,Inactive,0,0,0,0,0,0
NSC,2006,Inactive,0,0,0,0,0,0
NSC,2007,Inactive,0,0,0,0,0,0
NSC,2008,Inactive,0,0,0,0,0,0
NSC,2009,Inactive,0,0,0,0,0,0
NSC,2010,Inactive,0,0,0,0,0,0
NSC,2011,Inactive,0,0,0,0,0,0
NSC,2012,Inactive,0,0,0,0,0,0
NSC,2013,Active,1,0,0,0,0,1
NSC,2014,Active,0,0,0,0,0,0
NSC,2015,Active,0,0,0,0,0,0
NSC,2016,Active,0,0,0,0,0,0
NSC,2017,Active,0,0,0,0,0,0
OREN,1957,Inactive,0,0,0,0,0,0
OREN,1958,Inactive,0,0,0,0,0,0
OREN,1959,Inactive,0,0,0,0,0,0
OREN,1960,Inactive,0,0,0,0,0,0
OREN,1961,Inactive,0,0,0,0,0,0
OREN,1962,Inactive,0,0,0,0,0,0
OREN,1963,Inactive,0,0,0,0,0,0
OREN,1964,Inactive,0,0,0,0,0,0
OREN,1965,Inactive,0,0,0,0,0,0
OREN,1966,Inactive,0,0,0,0,0,0
OREN,1967,Inactive,0,0,0,0,0,0
OREN,1968,Inactive,0,0,0,0,0,0
OREN,1969,Inactive,0,0,0,0,0,0
OREN,1970,Inactive,0,0,0,0,0,0
OREN,1971,Inactive,0,0,0,0,0,0
OREN,1972,Inactive,0,0,0,0,0,0
OREN,1973,Inactive,0,0,0,0,0,0
OREN,1974,Inactive,0,0,0,0,0,0
OREN,1975,Inactive,0,0,0,0,0,0
OREN,1976,Inactive,0,0,0,0,0,0
OREN,1977,Inactive,0,0,0,0,0,0
OREN,1978,Inactive,0,0,0,0,0,0
OREN,1979,Inactive,0,0,0,0,0,0
OREN,1980,Inactive,0,0,0,0,0,0
OREN,1981,Inactive,0,0,0,0,0,0
OREN,1982,Inactive,0,0,0,0,0,0
OREN,1983,Inactive,0,0,0,0,0,0
OREN,1984,Inactive,0,0,0,0,0,0
OREN,1985,Inactive,0,0,0,0,0,0
OREN,1986,Inactive,0,0,0,0,0,0
OREN,1987,Inactive,0,0,0,0,0,0
OREN,1988,Inactive,0,0,0,0,0,0
OREN,1989,Inactive,0,0,0,0,0,0
OREN,1990,Inactive,0,0,0,0,0,0
OREN,1991,Inactive,0,0,0,0,0,0
OREN,1992,Inactive,0,0,0,0,0,0
OREN,1993,Inactive,0,0,0,0,0,0
OREN,1994,Inactive,0,0,0,0,0,0
OREN,1995,Inactive,0,0,0,0,0,0
OREN,1996,Inactive,0,0,0,0,0,0
OREN,1997,Inactive,0,0,0,0,0,0
OREN,1998,Inactive,0,0,0,0,0,0
OREN,1999,Inactive,0,0,0,0,0,0
OREN,2000,Inactive,0,0,0,0,0,0
OREN,2001,Inactive,0,0,0,0,0,0
OREN,2002,Inactive,0,0,0,0,0,0
OREN,2003,Inactive,0,0,0,0,0,0
OREN,2004,Inactive,0,0,0,0,0,0
OREN,2005,Inactive,0,0,0,0,0,0
OREN,2006,Active,1,0,0,0,0,1
OREN,2007,Active,1,0,0,0,0,1
OREN,2008,Active,1,0,0,0,0,1
OREN,2009,Active,0,0,0,0,0,0
OREN,2010,Active,1,0,0,0,0,1
OREN,2011,Active,1,0,0,0,0,1
OREN,2012,Active,0,0,0,0,0,0
OREN,2013,Active,3,0,0,0,0,3
OREN,2014,Active,3,0,0,0,0,3
OREN,2015,Active,1,0,0,0,0,1
OREN,2016,Active,0,0,0,0,0,0
OREN,2017,Active,0,0,0,0,0,0
PKMTR,1957,Inactive,0,0,0,0,0,0
PKMTR,1958,Inactive,0,0,0,0,0,0
PKMTR,1959,Inactive,0,0,0,0,0,0
PKMTR,1960,Inactive,0,0,0,0,0,0
PKMTR,1961,Inactive,0,0,0,0,0,0
PKMTR,1962,Inactive,0,0,0,0,0,0
PKMTR,1963,Inactive,0,0,0,0,0,0
PKMTR,1964,Inactive,0,0,0,0,0,0
PKMTR,1965,Inactive,0,0,0,0,0,0
PKMTR,1966,Active,6,0,0,0,0,6
PKMTR,1967,Active,26,0,0,0,0,26
PKMTR,1968,Active,30,0,0,0,0,30
PKMTR,1969,Active,37,0,0,0,0,37
PKMTR,1970,Active,44,2,0,2,0,48
PKMTR,1971,Active,50,2,0,1,0,53
PKMTR,1972,Active,46,3,0,3,0,52
PKMTR,1973,Active,55,3,0,3,0,61
PKMTR,1974,Active,52,1,0,2,0,55
PKMTR,1975,Active,57,2,0,3,0,62
PKMTR,1976,Active,62,2,0,0,0,64
PKMTR,1977,Active,62,2,0,5,0,69
PKMTR,1978,Active,58,3,0,1,0,62
PKMTR,1979,Active,64,2,0,0,0,66
PKMTR,1980,Active,59,3,0,2,0,64
PKMTR,1981,Active,53,5,0,1,0,59
PKMTR,1982,Active,51,4,0,1,0,56
PKMTR,1983,Active,59,1,0,2,0,62
PKMTR,1984,Active,54,6,0,2,0,62
PKMTR,1985,Active,53,8,0,0,0,61
PKMTR,1986,Active,51,4,0,1,0,56
PKMTR,1987,Active,44,2,0,1,0,47
PKMTR,1988,Active,44,3,0,0,0,47
PKMTR,1989,Active,43,2,0,0,0,45
PKMTR,1990,Active,45,3,0,0,0,48
PKMTR,1991,Active,32,2,0,2,0,36
PKMTR,1992,Active,31,1,0,1,0,33
PKMTR,1993,Active,22,3,0,1,0,26
PKMTR,1994,Active,16,2,0,0,0,18
PKMTR,1995,Active,11,0,0,2,0,13
PKMTR,1996,Active,10,0,0,0,0,10
PKMTR,1997,Active,6,2,0,1,0,9
PKMTR,1998,Active,5,1,0,1,0,7
PKMTR,1999,Active,4,1,0,1,0,6
PKMTR,2000,Active,4,0,0,0,0,4
PKMTR,2001,Active,6,0,0,0,0,6
PKMTR,2002,Active,9,0,0,0,0,9
PKMTR,2003,Active,7,0,0,0,0,7
PKMTR,2004,Active,5,0,0,0,0,5
PKMTR,2005,Active,4,0,0,0,0,4
PKMTR,2006,Active,2,0,0,2,1,5
PKMTR,2007,Active,2,0,0,1,2,5
PKMTR,2008,Active,4,0,0,0,2,6
PKMTR,2009,Active,7,1,0,0,0,8
PKMTR,2010,Active,4,0,0,2,0,6
PKMTR,2011,Active,2,3,0,1,0,6
PKMTR,2012,Active,2,0,0,1,0,3
PKMTR,2013,Active,6,1,0,0,0,7
PKMTR,2014,Active,4,3,0,2,0,9
PKMTR,2015,Active,6,0,0,1,0,7
PKMTR,2016,Active,3,2,0,0,0,5
PKMTR,2017,Active,3,1,0,1,0,5
RLLC,1957,Inactive,0,0,0,0,0,0
RLLC,1958,Inactive,0,0,0,0,0,0
RLLC,1959,Inactive,0,0,0,0,0,0
RLLC,1960,Inactive,0,0,0,0,0,0
RLLC,1961,Inactive,0,0,0,0,0,0
RLLC,1962,Inactive,0,0,0,0,0,0
RLLC,1963,Inactive,0,0,0,0,0,0
RLLC,1964,Inactive,0,0,0,0,0,0
RLLC,1965,Inactive,0,0,0,0,0,0
RLLC,1966,Inactive,0,0,0,0,0,0
RLLC,1967,Inactive,0,0,0,0,0,0
RLLC,1968,Inactive,0,0,0,0,0,0
RLLC,1969,Inactive,0,0,0,0,0,0
RLLC,1970,Inactive,0,0,0,0,0,0
RLLC,1971,Inactive,0,0,0,0,0,0
RLLC,1972,Inactive,0,0,0,0,0,0
RLLC,1973,Inactive,0,0,0,0,0,0
RLLC,1974,Inactive,0,0,0,0,0,0
RLLC,1975,Inactive,0,0,0,0,0,0
RLLC,1976,Inactive,0,0,0,0,0,0
RLLC,1977,Inactive,0,0,0,0,0,0
RLLC,1978,Inactive,0,0,0,0,0,0
RLLC,1979,Inactive,0,0,0,0,0,0
RLLC,1980,Inactive,0,0,0,0,0,0
RLLC,1981,Inactive,0,0,0,0,0,0
RLLC,1982,Inactive,0,0,0,0,0,0
RLLC,1983,Inactive,0,0,0,0,0,0
RLLC,1984,Inactive,0,0,0,0,0,0
RLLC,1985,Inactive,0,0,0,0,0,0
RLLC,1986,Inactive,0,0,0,0,0,0
RLLC,1987,Inactive,0,0,0,0,0,0
RLLC,1988,Inactive,0,0,0,0,0,0
RLLC,1989,Inactive,0,0,0,0,0,0
RLLC,1990,Inactive,0,0,0,0,0,0
RLLC,1991,Inactive,0,0,0,0,0,0
RLLC,1992,Inactive,0,0,0,0,0,0
RLLC,1993,Inactive,0,0,0,0,0,0
RLLC,1994,Inactive,0,0,0,0,0,0
RLLC,1995,Inactive,0,0,0,0,0,0
RLLC,1996,Inactive,0,0,0,0,0,0
RLLC,1997,Inactive,0,0,0,0,0,0
RLLC,1998,Inactive,0,0,0,0,0,0
RLLC,1999,Inactive,0,0,0,0,0,0
RLLC,2000,Inactive,0,0,0,0,0,0
RLLC,2001,Inactive,0,0,0,0,0,0
RLLC,2002,Inactive,0,0,0,0,0,0
RLLC,2003,Inactive,0,0,0,0,0,0
RLLC,2004,Inactive,0,0,0,0,0,0
RLLC,2005,Inactive,0,0,0,0,0,0
RLLC,2006,Inactive,0,0,0,0,0,0
RLLC,2007,Inactive,0,0,0,0,0,0
RLLC,2008,Inactive,0,0,0,0,0,0
RLLC,2009,Inactive,0,0,0,0,0,0
RLLC,2010,Inactive,0,0,0,0,0,0
RLLC,2011,Inactive,0,0,0,0,0,0
RLLC,2012,Inactive,0,0,0,0,0,0
RLLC,2013,Inactive,0,0,0,0,0,0
RLLC,2014,Inactive,0,0,0,0,0,0
RLLC,2015,Inactive,0,0,0,0,0,0
RLLC,2016,Inactive,0,0,0,0,0,0
RLLC,2017,Inactive,0,0,0,0,0,0
SEM,1957,Inactive,0,0,0,0,0,0
SEM,1958,Inactive,0,0,0,0,0,0
SEM,1959,Inactive,0,0,0,0,0,0
SEM,1960,Inactive,0,0,0,0,0,0
SEM,1961,Inactive,0,0,0,0,0,0
SEM,1962,Inactive,0,0,0,0,0,0
SEM,1963,Inactive,0,0,0,0,0,0
SEM,1964,Inactive,0,0,0,0,0,0
SEM,1965,Inactive,0,0,0,0,0,0
SEM,1966,Inactive,0,0,0,0,0,0
SEM,1967,Inactive,0,0,0,0,0,0
SEM,1968,Inactive,0,0,0,0,0,0
SEM,1969,Inactive,0,0,0,0,0,0
SEM,1970,Inactive,0,0,0,0,0,0
SEM,1971,Inactive,0,0,0,0,0,0
SEM,1972,Inactive,0,0,0,0,0,0
SEM,1973,Inactive,0,0,0,0,0,0
SEM,1974,Inactive,0,0,0,0,0,0
SEM,1975,Inactive,0,0,0,0,0,0
SEM,1976,Inactive,0,0,0,0,0,0
SEM,1977,Inactive,0,0,0,0,0,0
SEM,1978,Inactive,0,0,0,0,0,0
SEM,1979,Inactive,0,0,0,0,0,0
SEM,1980,Inactive,0,0,0,0,0,0
SEM,1981,Inactive,0,0,0,0,0,0
SEM,1982,Inactive,0,0,0,0,0,0
SEM,1983,Inactive,0,0,0,0,0,0
SEM,1984,Inactive,0,0,0,0,0,0
SEM,1985,Inactive,0,0,0,0,0,0
SEM,1986,Inactive,0,0,0,0,0,0
SEM,1987,Inactive,0,0,0,0,0,0
SEM,1988,Inactive,0,0,0,0,0,0
SEM,1989,Inactive,0,0,0,0,0,0
SEM,1990,Inactive,0,0,0,0,0,0
SEM,1991,Inactive,0,0,0,0,0,0
SEM,1992,Inactive,0,0,0,0,0,0
SEM,1993,Inactive,0,0,0,0,0,0
SEM,1994,Inactive,0,0,0,0,0,0
SEM,1995,Inactive,0,0,0,0,0,0
SEM,1996,Inactive,0,0,0,0,0,0
SEM,1997,Inactive,0,0,0,0,0,0
SEM,1998,Inactive,0,0,0,0,0,0
SEM,1999,Inactive,0,0,0,0,0,0
SEM,2000,Inactive,0,0,0,0,0,0
SEM,2001,Inactive,0,0,0,0,0,0
SEM,2002,Inactive,0,0,0,0,0,0
SEM,2003,Inactive,0,0,0,0,0,0
SEM,2004,Inactive,0,0,0,0,0,0
SEM,2005,Inactive,0,0,0,0,0,0
SEM,2006,Inactive,0,0,0,0,0,0
SEM,2007,Inactive,0,0,0,0,0,0
SEM,2008,Inactive,0,0,0,0,0,0
SEM,2009,Active,1,0,0,0,0,1
SEM,2010,Active,0,0,0,0,0,0
SEM,2011,Active,1,0,0,0,0,1
SEM,2012,Active,1,0,0,0,0,1
SEM,2013,Active,0,0,0,0,0,0
SEM,2014,Active,0,0,0,0,0,0
SEM,2015,Active,1,0,0,0,0,1
SEM,2016,Active,0,0,0,0,0,0
SEM,2017,Active,0,0,0,0,0,0
SNMLP,1957,Inactive,0,0,0,0,0,0
SNMLP,1958,Inactive,0,0,0,0,0,0
SNMLP,1959,Inactive,0,0,0,0,0,0
SNMLP,1960,Inactive,0,0,0,0,0,0
SNMLP,1961,Inactive,0,0,0,0,0,0
SNMLP,1962,Inactive,0,0,0,0,0,0
SNMLP,1963,Inactive,0,0,0,0,0,0
SNMLP,1964,Inactive,0,0,0,0,0,0
SNMLP,1965,Inactive,0,0,0,0,0,0
SNMLP,1966,Inactive,0,0,0,0,0,0
SNMLP,1967,Active,1,0,0,0,0,1
SNMLP,1968,Active,0,0,0,0,0,0
SNMLP,1969,Active,0,0,0,0,0,0
SNMLP,1970,Active,1,0,0,0,0,1
SNMLP,1971,Active,2,0,0,0,0,2
SNMLP,1972,Active,1,0,0,0,0,1
SNMLP,1973,Active,0,0,0,0,0,0
SNMLP,1974,Active,2,0,0,0,0,2
SNMLP,1975,Active,1,0,0,0,0,1
SNMLP,1976,Active,0,0,0,0,0,0
SNMLP,1977,Active,0,0,0,0,0,0
SNMLP,1978,Active,0,0,0,0,0,0
SNMLP,1979,Active,0,0,0,0,0,0
SNMLP,1980,Active,0,0,0,0,0,0
SNMLP,1981,Active,0,0,0,0,0,0
SNMLP,1982,Active,0,0,0,0,0,0
SNMLP,1983,Active,0,0,0,0,0,0
SNMLP,1984,Active,0,0,0,0,0,0
SNMLP,1985,Active,0,0,0,0,0,0
SNMLP,1986,Active,0,0,0,0,0,0
SNMLP,1987,Active,0,0,0,0,0,0
SNMLP,1988,Active,1,0,0,0,0,1
SNMLP,1989,Inactive,0,0,0,0,0,0
SNMLP,1990,Inactive,0,0,0,0,0,0
SNMLP,1991,Inactive,0,0,0,0,0,0
SNMLP,1992,Inactive,0,0,0,0,0,0
SNMLP,1993,Inactive,0,0,0,0,0,0
SNMLP,1994,Inactive,0,0,0,0,0,0
SNMLP,1995,Inactive,0,0,0,0,0,0
SNMLP,1996,Inactive,0,0,0,0,0,0
SNMLP,1997,Inactive,0,0,0,0,0,0
SNMLP,1998,Inactive,0,0,0,0,0,0
SNMLP,1999,Inactive,0,0,0,0,0,0
SNMLP,2000,Inactive,0,0,0,0,0,0
SNMLP,2001,Inactive,0,0,0,0,0,0
SNMLP,2002,Inactive,0,0,0,0,0,0
SNMLP,2003,Inactive,0,0,0,0,0,0
SNMLP,2004,Inactive,0,0,0,0,0,0
SNMLP,2005,Inactive,0,0,0,0,0,0
SNMLP,2006,Inactive,0,0,0,0,0,0
SNMLP,2007,Inactive,0,0,0,0,0,0
SNMLP,2008,Inactive,0,0,0,0,0,0
SNMLP,2009,Inactive,0,0,0,0,0,0
SNMLP,2010,Inactive,0,0,0,0,0,0
SNMLP,2011,Inactive,0,0,0,0,0,0
SNMLP,2012,Inactive,0,0,0,0,0,0
SNMLP,2013,Inactive,0,0,0,0,0,0
SNMLP,2014,Inactive,0,0,0,0,0,0
SNMLP,2015,Inactive,0,0,0,0,0,0
SNMLP,2016,Inactive,0,0,0,0,0,0
SNMLP,2017,Inactive,0,0,0,0,0,0
SRI,1957,Inactive,0,0,0,0,0,0
SRI,1958,Inactive,0,0,0,0,0,0
SRI,1959,Inactive,0,0,0,0,0,0
SRI,1960,Inactive,0,0,0,0,0,0
SRI,1961,Inactive,0,0,0,0,0,0
SRI,1962,Inactive,0,0,0,0,0,0
SRI,1963,Inactive,0,0,0,0,0,0
SRI,1964,Inactive,0,0,0,0,0,0
SRI,1965,Inactive,0,0,0,0,0,0
SRI,1966,Inactive,0,0,0,0,0,0
SRI,1967,Inactive,0,0,0,0,0,0
SRI,1968,Inactive,0,0,0,0,0,0
SRI,1969,Inactive,0,0,0,0,0,0
SRI,1970,Inactive,0,0,0,0,0,0
SRI,1971,Inactive,0,0,0,0,0,0
SRI,1972,Inactive,0,0,0,0,0,0
SRI,1973,Inactive,0,0,0,0,0,0
SRI,1974,Inactive,0,0,0,0,0,0
SRI,1975,Inactive,0,0,0,0,0,0
SRI,1976,Inactive,0,0,0,0,0,0
SRI,1977,Inactive,0,0,0,0,0,0
SRI,1978,Inactive,0,0,0,0,0,0
SRI,1979,Inactive,0,0,0,0,0,0
SRI,1980,Active,1,0,0,0,0,1
SRI,1981,Active,1,0,0,0,0,1
SRI,1982,Active,0,0,0,0,0,0
SRI,1983,Active,1,0,0,0,0,1
SRI,1984,Active,0,0,0,0,0,0
SRI,1985,Active,0,0,0,0,0,0
SRI,1986,Active,0,0,0,0,0,0
SRI,1987,Active,0,0,0,0,0,0
SRI,1988,Active,0,0,0,0,0,0
SRI,1989,Active,0,0,0,0,0,0
SRI,1990,Active,0,0,0,0,0,0
SRI,1991,Active,0,0,0,0,0,0
SRI,1992,Active,1,0,0,0,0,1
SRI,1993,Active,0,0,0,0,0,0
SRI,1994,Active,2,0,0,0,0,2
SRI,1995,Active,0,0,0,0,0,0
SRI,1996,Active,1,0,0,0,0,1
SRI,1997,Active,1,0,0,0,0,1
SRI,1998,Active,0,0,0,0,0,0
SRI,1999,Active,1,0,0,0,0,1
SRI,2000,Active,0,0,0,0,0,0
SRI,2001,Active,1,0,1,0,0,2
SRI,2002,Active,0,0,1,0,0,1
SRI,2003,Active,1,0,1,0,0,2
SRI,2004,Active,0,0,1,0,0,1
SRI,2005,Active,1,0,0,0,0,1
SRI,2006,Active,0,0,0,0,0,0
SRI,2007,Active,2,0,1,0,0,3
SRI,2008,Active,1,0,0,1,1,3
SRI,2009,Active,2,0,0,0,0,2
SRI,2010,Active,1,0,0,0,0,1
SRI,2011,Active,2,0,1,0,0,3
SRI,2012,Active,2,0,0,0,0,2
SRI,2013,Active,1,0,1,1,0,3
SRI,2014,Active,1,0,3,0,0,4
SRI,2015,Active,3,0,2,0,0,5
SRI,2016,Active,3,0,4,0,0,7
SRI,2017,Active,7,1,2,0,0,10
SVOB,1957,Inactive,0,0,0,0,0,0
SVOB,1958,Inactive,0,0,0,0,0,0
SVOB,1959,Inactive,0,0,0,0,0,0
SVOB,1960,Inactive,0,0,0,0,0,0
SVOB,1961,Inactive,0,0,0,0,0,0
SVOB,1962,Inactive,0,0,0,0,0,0
SVOB,1963,Inactive,0,0,0,0,0,0
SVOB,1964,Inactive,0,0,0,0,0,0
SVOB,1965,Inactive,0,0,0,0,0,0
SVOB,1966,Inactive,0,0,0,0,0,0
SVOB,1967,Inactive,0,0,0,0,0,0
SVOB,1968,Inactive,0,0,0,0,0,0
SVOB,1969,Inactive,0,0,0,0,0,0
SVOB,1970,Inactive,0,0,0,0,0,0
SVOB,1971,Inactive,0,0,0,0,0,0
SVOB,1972,Inactive,0,0,0,0,0,0
SVOB,1973,Inactive,0,0,0,0,0,0
SVOB,1974,Inactive,0,0,0,0,0,0
SVOB,1975,Inactive,0,0,0,0,0,0
SVOB,1976,Inactive,0,0,0,0,0,0
SVOB,1977,Inactive,0,0,0,0,0,0
SVOB,1978,Inactive,0,0,0,0,0,0
SVOB,1979,Inactive,0,0,0,0,0,0
SVOB,1980,Inactive,0,0,0,0,0,0
SVOB,1981,Inactive,0,0,0,0,0,0
SVOB,1982,Inactive,0,0,0,0,0,0
SVOB,1983,Inactive,0,0,0,0,0,0
SVOB,1984,Inactive,0,0,0,0,0,0
SVOB,1985,Inactive,0,0,0,0,0,0
SVOB,1986,Inactive,0,0,0,0,0,0
SVOB,1987,Inactive,0,0,0,0,0,0
SVOB,1988,Inactive,0,0,0,0,0,0
SVOB,1989,Inactive,0,0,0,0,0,0
SVOB,1990,Inactive,0,0,0,0,0,0
SVOB,1991,Inactive,0,0,0,0,0,0
SVOB,1992,Inactive,0,0,0,0,0,0
SVOB,1993,Inactive,0,0,0,0,0,0
SVOB,1994,Inactive,0,0,0,0,0,0
SVOB,1995,Inactive,0,0,0,0,0,0
SVOB,1996,Inactive,0,0,0,0,0,0
SVOB,1997,Active,2,0,0,0,0,2
SVOB,1998,Active,0,0,0,0,0,0
SVOB,1999,Active,0,0,0,0,0,0
SVOB,2000,Active,1,0,0,0,0,1
SVOB,2001,Active,1,0,0,0,0,1
SVOB,2002,Active,0,0,0,0,0,0
SVOB,2003,Active,0,0,0,0,0,0
SVOB,2004,Active,0,0,0,0,0,0
SVOB,2005,Active,0,0,0,0,0,0
SVOB,2006,Active,1,0,0,0,0,1
SVOB,2007,Inactive,0,0,0,0,0,0
SVOB,2008,Inactive,0,0,0,0,0,0
SVOB,2009,Inactive,0,0,0,0,0,0
SVOB,2010,Inactive,0,0,0,0,0,0
SVOB,2011,Inactive,0,0,0,0,0,0
SVOB,2012,Inactive,0,0,0,0,0,0
SVOB,2013,Inactive,0,0,0,0,0,0
SVOB,2014,Inactive,0,0,0,0,0,0
SVOB,2015,Inactive,0,0,0,0,0,0
SVOB,2016,Inactive,0,0,0,0,0,0
SVOB,2017,Inactive,0,0,0,0,0,0
TNSTA,1957,Inactive,0,0,0,0,0,0
TNSTA,1958,Inactive,0,0,0,0,0,0
TNSTA,1959,Inactive,0,0,0,0,0,0
TNSTA,1960,Inactive,0,0,0,0,0,0
TNSTA,1961,Inactive,0,0,0,0,0,0
TNSTA,1962,Inactive,0,0,0,0,0,0
TNSTA,1963,Inactive,0,0,0,0,0,0
TNSTA,1964,Inactive,0,0,0,0,0,0
TNSTA,1965,Inactive,0,0,0,0,0,0
TNSTA,1966,Inactive,0,0,0,0,0,0
TNSTA,1967,Inactive,0,0,0,0,0,0
TNSTA,1968,Inactive,0,0,0,0,0,0
TNSTA,1969,Inactive,0,0,0,0,0,0
TNSTA,1970,Inactive,0,0,0,0,0,0
TNSTA,1971,Inactive,0,0,0,0,0,0
TNSTA,1972,Inactive,0,0,0,0,0,0
TNSTA,1973,Inactive,0,0,0,0,0,0
TNSTA,1974,Inactive,0,0,0,0,0,0
TNSTA,1975,Active,1,0,0,0,0,1
TNSTA,1976,Active,1,0,0,0,0,1
TNSTA,1977,Active,0,0,1,0,0,1
TNSTA,1978,Active,1,0,0,0,0,1
TNSTA,1979,Active,0,1,0,0,0,1
TNSTA,1980,Active,0,1,0,0,0,1
TNSTA,1981,Active,0,1,1,0,0,2
TNSTA,1982,Active,1,0,0,0,0,1
TNSTA,1983,Active,0,0,2,0,0,2
TNSTA,1984,Active,0,0,2,0,0,2
TNSTA,1985,Active,0,0,0,0,0,0
TNSTA,1986,Active,1,0,1,0,0,2
TNSTA,1987,Active,1,0,1,0,0,2
TNSTA,1988,Active,0,0,2,0,0,2
TNSTA,1989,Active,0,0,1,0,0,1
TNSTA,1990,Active,1,0,1,0,0,2
TNSTA,1991,Active,0,0,1,0,0,1
TNSTA,1992,Active,1,0,0,0,0,1
TNSTA,1993,Active,0,0,0,0,0,0
TNSTA,1994,Active,1,0,0,1,0,2
TNSTA,1995,Active,1,0,0,0,0,1
TNSTA,1996,Active,1,0,0,0,0,1
TNSTA,1997,Active,1,0,0,0,0,1
TNSTA,1998,Active,0,1,0,0,0,1
TNSTA,1999,Active,0,0,0,0,0,0
TNSTA,2000,Active,0,0,0,0,0,0
TNSTA,2001,Active,0,1,0,0,0,1
TNSTA,2002,Active,2,1,0,0,0,3
TNSTA,2003,Active,0,0,0,0,1,1
TNSTA,2004,Active,0,0,0,0,0,0
TNSTA,2005,Active,0,0,1,0,0,1
TNSTA,2006,Active,1,0,2,0,1,4
TNSTA,2007,Active,0,0,0,1,1,2
TNSTA,2008,Active,0,0,1,0,0,1
TNSTA,2009,Active,2,0,0,0,1,3
TNSTA,2010,Active,1,0,0,1,0,2
TNSTA,2011,Active,1,0,0,0,2,3
TNSTA,2012,Active,2,0,0,0,0,2
TNSTA,2013,Active,1,0,0,0,1,2
TNSTA,2014,Active,2,0,1,1,0,4
TNSTA,2015,Active,1,0,1,0,2,4
TNSTA,2016,Active,2,0,1,0,0,3
TNSTA,2017,Active,1,0,1,2,2,6
TSC,1957,Inactive,0,0,0,0,0,0
TSC,1958,Inactive,0,0,0,0,0,0
TSC,1959,Inactive,0,0,0,0,0,0
TSC,1960,Inactive,0,0,0,0,0,0
TSC,1961,Inactive,0,0,0,0,0,0
TSC,1962,Inactive,0,0,0,0,0,0
TSC,1963,Inactive,0,0,0,0,0,0
TSC,1964,Inactive,0,0,0,0,0,0
TSC,1965,Inactive,0,0,0,0,0,0
TSC,1966,Inactive,0,0,0,0,0,0
TSC,1967,Inactive,0,0,0,0,0,0
TSC,1968,Inactive,0,0,0,0,0,0
TSC,1969,Inactive,0,0,0,0,0,0
TSC,1970,Inactive,0,0,0,0,0,0
TSC,1971,Inactive,0,0,0,0,0,0
TSC,1972,Inactive,0,0,0,0,0,0
TSC,1973,Inactive,0,0,0,0,0,0
TSC,1974,Inactive,0,0,0,0,0,0
TSC,1975,Inactive,0,0,0,0,0,0
TSC,1976,Inactive,0,0,0,0,0,0
TSC,1977,Inactive,0,0,0,0,0,0
TSC,1978,Inactive,0,0,0,0,0,0
TSC,1979,Inactive,0,0,0,0,0,0
TSC,1980,Inactive,0,0,0,0,0,0
TSC,1981,Inactive,0,0,0,0,0,0
TSC,1982,Inactive,0,0,0,0,0,0
TSC,1983,Inactive,0,0,0,0,0,0
TSC,1984,Inactive,0,0,0,0,0,0
TSC,1985,Inactive,0,0,0,0,0,0
TSC,1986,Inactive,0,0,0,0,0,0
TSC,1987,Inactive,0,0,0,0,0,0
TSC,1988,Active,1,0,0,0,0,1
TSC,1989,Active,0,0,0,0,0,0
TSC,1990,Active,1,0,0,0,0,1
TSC,1991,Active,0,0,0,0,0,0
TSC,1992,Active,0,0,0,0,0,0
TSC,1993,Active,0,0,0,0,0,0
TSC,1994,Active,0,0,0,0,0,0
TSC,1995,Active,0,0,0,0,0,0
TSC,1996,Active,0,0,0,0,0,0
TSC,1997,Active,2,0,0,0,0,2
TSC,1998,Active,4,0,0,0,0,4
TSC,1999,Active,3,0,0,0,0,3
TSC,2000,Active,1,0,0,0,0,1
TSC,2001,Active,0,0,0,0,0,0
TSC,2002,Active,2,0,0,0,0,2
TSC,2003,Active,1,0,0,0,0,1
TSC,2004,Active,2,1,0,0,0,3
TSC,2005,Active,0,0,0,0,0,0
TSC,2006,Active,2,0,0,0,0,2
TSC,2007,Active,3,0,0,0,0,3
TSC,2008,Active,4,0,0,0,0,4
TSC,2009,Active,2,0,0,0,0,2
TSC,2010,Active,3,0,0,0,0,3
TSC,2011,Active,4,0,0,0,0,4
TSC,2012,Active,5,0,0,0,0,5
TSC,2013,Active,4,0,0,0,0,4
TSC,2014,Active,6,0,0,0,0,6
TSC,2015,Active,4,0,0,0,0,4
TSC,2016,Active,3,0,0,0,0,3
TSC,2017,Active,2,0,0,0,0,2
TTMTR,1957,Active,2,0,0,0,0,2
TTMTR,1958,Active,1,0,0,0,0,1
TTMTR,1959,Active,0,0,0,3,0,3
TTMTR,1960,Active,3,0,0,0,0,3
TTMTR,1961,Active,5,0,0,1,0,6
TTMTR,1962,Active,13,0,0,0,0,13
TTMTR,1963,Active,12,0,0,0,0,12
TTMTR,1964,Active,18,2,0,0,0,20
TTMTR,1965,Active,33,0,0,8,0,41
TTMTR,1966,Active,24,1,0,6,0,31
TTMTR,1967,Active,29,2,0,2,0,33
TTMTR,1968,Active,28,3,0,5,0,36
TTMTR,1969,Active,23,2,0,4,0,29
TTMTR,1970,Active,21,2,0,5,0,28
TTMTR,1971,Active,24,1,0,4,0,29
TTMTR,1972,Active,15,1,0,4,0,20
TTMTR,1973,Active,15,1,0,7,0,23
TTMTR,1974,Active,21,0,2,2,0,25
TTMTR,1975,Active,22,0,2,2,0,26
TTMTR,1976,Active,28,1,2,3,0,34
TTMTR,1977,Active,24,0,2,1,0,27
TTMTR,1978,Active,19,0,1,4,1,25
TTMTR,1979,Active,14,0,5,0,0,19
TTMTR,1980,Active,18,0,5,1,0,24
TTMTR,1981,Active,31,0,4,3,0,38
TTMTR,1982,Active,34,1,6,0,0,41
TTMTR,1983,Active,20,2,6,3,1,32
TTMTR,1984,Active,21,2,8,2,0,33
TTMTR,1985,Active,26,2,6,1,0,35
TTMTR,1986,Active,28,1,6,0,0,35
TTMTR,1987,Active,38,1,8,0,0,47
TTMTR,1988,Active,31,2,7,3,0,43
TTMTR,1989,Active,18,2,7,2,0,29
TTMTR,1990,Active,18,2,7,0,0,27
TTMTR,1991,Active,14,1,7,1,0,23
TTMTR,1992,Active,13,2,6,0,0,21
TTMTR,1993,Active,16,1,4,0,0,21
TTMTR,1994,Active,16,4,10,0,0,30
TTMTR,1995,Active,13,3,3,0,0,19
TTMTR,1996,Active,9,0,5,0,0,14
TTMTR,1997,Active,10,1,6,0,0,17
TTMTR,1998,Active,21,1,3,1,0,26
TTMTR,1999,Active,12,0,7,0,0,19
TTMTR,2000,Active,13,5,9,2,1,30
TTMTR,2001,Active,10,1,5,0,0,16
TTMTR,2002,Active,7,2,5,1,0,15
TTMTR,2003,Active,7,1,5,1,0,14
TTMTR,2004,Active,9,1,7,0,0,17
TTMTR,2005,Active,9,2,7,1,0,19
TTMTR,2006,Active,10,2,4,0,0,16
TTMTR,2007,Active,13,2,4,0,0,19
TTMTR,2008,Active,7,3,9,0,0,19
TTMTR,2009,Active,10,1,12,0,1,24
TTMTR,2010,Active,12,2,9,0,0,23
TTMTR,2011,Active,11,2,9,1,0,23
TTMTR,2012,Active,11,0,10,0,0,21
TTMTR,2013,Active,12,0,10,0,0,22
TTMTR,2014,Active,13,0,7,0,0,20
TTMTR,2015,Active,9,0,8,0,0,17
TTMTR,2016,Active,7,0,2,1,0,10
TTMTR,2017,Active,10,0,5,0,0,15
VOSTO,1957,Inactive,0,0,0,0,0,0
VOSTO,1958,Inactive,0,0,0,0,0,0
VOSTO,1959,Inactive,0,0,0,0,0,0
VOSTO,1960,Inactive,0,0,0,0,0,0
VOSTO,1961,Inactive,0,0,0,0,0,0
VOSTO,1962,Inactive,0,0,0,0,0,0
VOSTO,1963,Inactive,0,0,0,0,0,0
VOSTO,1964,Inactive,0,0,0,0,0,0
VOSTO,1965,Inactive,0,0,0,0,0,0
VOSTO,1966,Inactive,0,0,0,0,0,0
VOSTO,1967,Inactive,0,0,0,0,0,0
VOSTO,1968,Inactive,0,0,0,0,0,0
VOSTO,1969,Inactive,0,0,0,0,0,0
VOSTO,1970,Inactive,0,0,0,0,0,0
VOSTO,1971,Inactive,0,0,0,0,0,0
VOSTO,1972,Inactive,0,0,0,0,0,0
VOSTO,1973,Inactive,0,0,0,0,0,0
VOSTO,1974,Inactive,0,0,0,0,0,0
VOSTO,1975,Inactive,0,0,0,0,0,0
VOSTO,1976,Inactive,0,0,0,0,0,0
VOSTO,1977,Inactive,0,0,0,0,0,0
VOSTO,1978,Inactive,0,0,0,0,0,0
VOSTO,1979,Inactive,0,0,0,0,0,0
VOSTO,1980,Inactive,0,0,0,0,0,0
VOSTO,1981,Inactive,0,0,0,0,0,0
VOSTO,1982,Inactive,0,0,0,0,0,0
VOSTO,1983,Inactive,0,0,0,0,0,0
VOSTO,1984,Inactive,0,0,0,0,0,0
VOSTO,1985,Inactive,0,0,0,0,0,0
VOSTO,1986,Inactive,0,0,0,0,0,0
VOSTO,1987,Inactive,0,0,0,0,0,0
VOSTO,1988,Inactive,0,0,0,0,0,0
VOSTO,1989,Inactive,0,0,0,0,0,0
VOSTO,1990,Inactive,0,0,0,0,0,0
VOSTO,1991,Inactive,0,0,0,0,0,0
VOSTO,1992,Inactive,0,0,0,0,0,0
VOSTO,1993,Inactive,0,0,0,0,0,0
VOSTO,1994,Inactive,0,0,0,0,0,0
VOSTO,1995,Inactive,0,0,0,0,0,0
VOSTO,1996,Inactive,0,0,0,0,0,0
VOSTO,1997,Inactive,0,0,0,0,0,0
VOSTO,1998,Inactive,0,0,0,0,0,0
VOSTO,1999,Inactive,0,0,0,0,0,0
VOSTO,2000,Inactive,0,0,0,0,0,0
VOSTO,2001,Inactive,0,0,0,0,0,0
VOSTO,2002,Inactive,0,0,0,0,0,0
VOSTO,2003,Inactive,0,0,0,0,0,0
VOSTO,2004,Inactive,0,0,0,0,0,0
VOSTO,2005,Inactive,0,0,0,0,0,0
VOSTO,2006,Inactive,0,0,0,0,0,0
VOSTO,2007,Inactive,0,0,0,0,0,0
VOSTO,2008,Inactive,0,0,0,0,0,0
VOSTO,2009,Inactive,0,0,0,0,0,0
VOSTO,2010,Inactive,0,0,0,0,0,0
VOSTO,2011,Inactive,0,0,0,0,0,0
VOSTO,2012,Inactive,0,0,0,0,0,0
VOSTO,2013,Inactive,0,0,0,0,0,0
VOSTO,2014,Inactive,0,0,0,0,0,0
VOSTO,2015,Inactive,0,0,0,0,0,0
VOSTO,2016,Active,1,0,0,0,0,1
VOSTO,2017,Active,0,0,0,0,0,0
WLPIS,1957,Inactive,0,0,0,0,0,0
WLPIS,1958,Inactive,0,0,0,0,0,0
WLPIS,1959,Inactive,0,0,0,0,0,0
WLPIS,1960,Inactive,0,0,0,0,0,0
WLPIS,1961,Active,2,0,0,0,0,2
WLPIS,1962,Active,1,0,0,0,0,1
WLPIS,1963,Active,1,0,0,0,0,1
WLPIS,1964,Active,3,0,0,0,0,3
WLPIS,1965,Active,2,1,0,0,0,3
WLPIS,1966,Active,0,1,0,0,0,1
WLPIS,1967,Active,0,0,0,0,0,0
WLPIS,1968,Active,1,0,0,0,0,1
WLPIS,1969,Active,0,0,0,0,0,0
WLPIS,1970,Active,1,0,0,0,0,1
WLPIS,1971,Active,2,0,0,0,0,2
WLPIS,1972,Active,1,0,0,0,0,1
WLPIS,1973,Active,0,0,0,0,0,0
WLPIS,1974,Active,0,0,0,0,0,0
WLPIS,1975,Active,0,0,0,0,0,0
WLPIS,1976,Active,0,0,0,0,0,0
WLPIS,1977,Active,0,0,0,0,0,0
WLPIS,1978,Active,0,0,0,0,0,0
WLPIS,1979,Active,2,0,0,0,0,2
WLPIS,1980,Active,0,0,0,0,0,0
WLPIS,1981,Active,0,0,0,0,0,0
WLPIS,1982,Active,0,0,0,0,0,0
WLPIS,1983,Active,0,0,0,0,0,0
WLPIS,1984,Active,0,0,0,0,0,0
WLPIS,1985,Active,1,0,0,0,0,1
WLPIS,1986,Active,0,0,0,0,0,0
WLPIS,1987,Active,0,0,0,0,0,0
WLPIS,1988,Active,0,0,0,0,0,0
WLPIS,1989,Active,0,0,0,0,0,0
WLPIS,1990,Active,0,0,0,0,0,0
WLPIS,1991,Active,0,0,0,0,0,0
WLPIS,1992,Active,0,0,0,0,0,0
WLPIS,1993,Active,0,0,0,0,0,0
WLPIS,1994,Active,0,0,0,0,0,0
WLPIS,1995,Active,0,0,0,0,0,0
WLPIS,1996,Active,1,0,0,0,0,1
WLPIS,1997,Active,0,0,0,0,0,0
WLPIS,1998,Active,0,0,0,0,0,0
WLPIS,1999,Active,0,0,0,0,0,0
WLPIS,2000,Active,0,0,0,0,0,0
WLPIS,2001,Active,0,0,0,0,0,0
WLPIS,2002,Active,0,0,0,0,0,0
WLPIS,2003,Active,0,0,0,0,0,0
WLPIS,2004,Active,0,0,0,0,0,0
WLPIS,2005,Active,0,0,0,0,0,0
WLPIS,2006,Active,1,0,0,0,0,1
WLPIS,2007,Active,1,0,0,0,0,1
WLPIS,2008,Active,0,0,0,0,0,0
WLPIS,2009,Active,1,0,0,0,0,1
WLPIS,2010,Active,0,0,0,0,0,0
WLPIS,2011,Active,0,0,0,0,1,1
WLPIS,2012,Active,0,0,0,0,0,0
WLPIS,2013,Active,4,0,0,1,0,5
WLPIS,2014,Active,2,0,0,0,0,2
WLPIS,2015,Active,0,0,0,0,0,0
WLPIS,2016,Active,1,0,0,0,0,1
WLPIS,2017,Active,1,0,0,0,0,1
WOMRA,1957,Inactive,0,0,0,0,0,0
WOMRA,1958,Inactive,0,0,0,0,0,0
WOMRA,1959,Inactive,0,0,0,0,0,0
WOMRA,1960,Inactive,0,0,0,0,0,0
WOMRA,1961,Inactive,0,0,0,0,0,0
WOMRA,1962,Inactive,0,0,0,0,0,0
WOMRA,1963,Inactive,0,0,0,0,0,0
WOMRA,1964,Inactive,0,0,0,0,0,0
WOMRA,1965,Inactive,0,0,0,0,0,0
WOMRA,1966,Inactive,0,0,0,0,0,0
WOMRA,1967,Active,1,0,0,0,0,1
WOMRA,1968,Active,0,0,0,0,0,0
WOMRA,1969,Active,0,0,0,0,0,0
WOMRA,1970,Active,0,0,0,0,0,0
WOMRA,1971,Active,1,0,0,0,0,1
WOMRA,1972,Inactive,0,0,0,0,0,0
WOMRA,1973,Inactive,0,0,0,0,0,0
WOMRA,1974,Inactive,0,0,0,0,0,0
WOMRA,1975,Inactive,0,0,0,0,0,0
WOMRA,1976,Inactive,0,0,0,0,0,0
WOMRA,1977,Inactive,0,0,0,0,0,0
WOMRA,1978,Inactive,0,0,0,0,0,0
WOMRA,1979,Inactive,0,0,0,0,0,0
WOMRA,1980,Inactive,0,0,0,0,0,0
WOMRA,1981,Inactive,0,0,0,0,0,0
WOMRA,1982,Inactive,0,0,0,0,0,0
WOMRA,1983,Inactive,0,0,0,0,0,0
WOMRA,1984,Inactive,0,0,0,0,0,0
WOMRA,1985,Inactive,0,0,0,0,0,0
WOMRA,1986,Inactive,0,0,0,0,0,0
WOMRA,1987,Inactive,0,0,0,0,0,0
WOMRA,1988,Inactive,0,0,0,0,0,0
WOMRA,1989,Inactive,0,0,0,0,0,0
WOMRA,1990,Inactive,0,0,0,0,0,0
WOMRA,1991,Inactive,0,0,0,0,0,0
WOMRA,1992,Inactive,0,0,0,0,0,0
WOMRA,1993,Inactive,0,0,0,0,0,0
WOMRA,1994,Inactive,0,0,0,0,0,0
WOMRA,1995,Inactive,0,0,0,0,0,0
WOMRA,1996,Inactive,0,0,0,0,0,0
WOMRA,1997,Inactive,0,0,0,0,0,0
WOMRA,1998,Inactive,0,0,0,0,0,0
WOMRA,1999,Inactive,0,0,0,0,0,0
WOMRA,2000,Inactive,0,0,0,0,0,0
WOMRA,2001,Inactive,0,0,0,0,0,0
WOMRA,2002,Inactive,0,0,0,0,0,0
WOMRA,2003,Inactive,0,0,0,0,0,0
WOMRA,2004,Inactive,0,0,0,0,0,0
WOMRA,2005,Inactive,0,0,0,0,0,0
WOMRA,2006,Inactive,0,0,0,0,0,0
WOMRA,2007,Inactive,0,0,0,0,0,0
WOMRA,2008,Inactive,0,0,0,0,0,0
WOMRA,2009,Inactive,0,0,0,0,0,0
WOMRA,2010,Inactive,0,0,0,0,0,0
WOMRA,2011,Inactive,0,0,0,0,0,0
WOMRA,2012,Inactive,0,0,0,0,0,0
WOMRA,2013,Inactive,0,0,0,0,0,0
WOMRA,2014,Inactive,0,0,0,0,0,0
WOMRA,2015,Inactive,0,0,0,0,0,0
WOMRA,2016,Inactive,0,0,0,0,0,0
WOMRA,2017,Inactive,0,0,0,0,0,0
WSC,1957,Inactive,0,0,0,0,0,0
WSC,1958,Inactive,0,0,0,0,0,0
WSC,1959,Inactive,0,0,0,0,0,0
WSC,1960,Inactive,0,0,0,0,0,0
WSC,1961,Inactive,0,0,0,0,0,0
WSC,1962,Inactive,0,0,0,0,0,0
WSC,1963,Inactive,0,0,0,0,0,0
WSC,1964,Inactive,0,0,0,0,0,0
WSC,1965,Inactive,0,0,0,0,0,0
WSC,1966,Inactive,0,0,0,0,0,0
WSC,1967,Inactive,0,0,0,0,0,0
WSC,1968,Inactive,0,0,0,0,0,0
WSC,1969,Inactive,0,0,0,0,0,0
WSC,1970,Inactive,0,0,0,0,0,0
WSC,1971,Inactive,0,0,0,0,0,0
WSC,1972,Inactive,0,0,0,0,0,0
WSC,1973,Inactive,0,0,0,0,0,0
WSC,1974,Inactive,0,0,0,0,0,0
WSC,1975,Inactive,0,0,0,0,0,0
WSC,1976,Inactive,0,0,0,0,0,0
WSC,1977,Inactive,0,0,0,0,0,0
WSC,1978,Inactive,0,0,0,0,0,0
WSC,1979,Inactive,0,0,0,0,0,0
WSC,1980,Inactive,0,0,0,0,0,0
WSC,1981,Inactive,0,0,0,0,0,0
WSC,1982,Inactive,0,0,0,0,0,0
WSC,1983,Inactive,0,0,0,0,0,0
WSC,1984,Inactive,0,0,0,0,0,0
WSC,1985,Inactive,0,0,0,0,0,0
WSC,1986,Inactive,0,0,0,0,0,0
WSC,1987,Inactive,0,0,0,0,0,0
WSC,1988,Inactive,0,0,0,0,0,0
WSC,1989,Inactive,0,0,0,0,0,0
WSC,1990,Inactive,0,0,0,0,0,0
WSC,1991,Inactive,0,0,0,0,0,0
WSC,1992,Inactive,0,0,0,0,0,0
WSC,1993,Inactive,0,0,0,0,0,0
WSC,1994,Inactive,0,0,0,0,0,0
WSC,1995,Inactive,0,0,0,0,0,0
WSC,1996,Inactive,0,0,0,0,0,0
WSC,1997,Inactive,0,0,0,0,0,0
WSC,1998,Inactive,0,0,0,0,0,0
WSC,1999,Inactive,0,0,0,0,0,0
WSC,2000,Inactive,0,0,0,0,0,0
WSC,2001,Inactive,0,0,0,0,0,0
WSC,2002,Inactive,0,0,0,0,0,0
WSC,2003,Inactive,0,0,0,0,0,0
WSC,2004,Inactive,0,0,0,0,0,0
WSC,2005,Inactive,0,0,0,0,0,0
WSC,2006,Inactive,0,0,0,0,0,0
WSC,2007,Inactive,0,0,0,0,0,0
WSC,2008,Inactive,0,0,0,0,0,0
WSC,2009,Inactive,0,0,0,0,0,0
WSC,2010,Inactive,0,0,0,0,0,0
WSC,2011,Inactive,0,0,0,0,0,0
WSC,2012,Inactive,0,0,0,0,0,0
WSC,2013,Inactive,0,0,0,0,0,0
WSC,2014,Inactive,0,0,0,0,0,0
WSC,2015,Inactive,0,0,0,0,0,0
WSC,2016,Active,0,0,1,0,0,1
WSC,2017,Active,1,0,0,0,0,1
XSC,1957,Inactive,0,0,0,0,0,0
XSC,1958,Inactive,0,0,0,0,0,0
XSC,1959,Inactive,0,0,0,0,0,0
XSC,1960,Inactive,0,0,0,0,0,0
XSC,1961,Inactive,0,0,0,0,0,0
XSC,1962,Inactive,0,0,0,0,0,0
XSC,1963,Inactive,0,0,0,0,0,0
XSC,1964,Inactive,0,0,0,0,0,0
XSC,1965,Inactive,0,0,0,0,0,0
XSC,1966,Inactive,0,0,0,0,0,0
XSC,1967,Inactive,0,0,0,0,0,0
XSC,1968,Inactive,0,0,0,0,0,0
XSC,1969,Inactive,0,0,0,0,0,0
XSC,1970,Inactive,0,0,0,0,0,0
XSC,1971,Inactive,0,0,0,0,0,0
XSC,1972,Inactive,0,0,0,0,0,0
XSC,1973,Inactive,0,0,0,0,0,0
XSC,1974,Inactive,0,0,0,0,0,0
XSC,1975,Inactive,0,0,0,0,0,0
XSC,1976,Inactive,0,0,0,0,0,0
XSC,1977,Inactive,0,0,0,0,0,0
XSC,1978,Inactive,0,0,0,0,0,0
XSC,1979,Inactive,0,0,0,0,0,0
XSC,1980,Inactive,0,0,0,0,0,0
XSC,1981,Inactive,0,0,0,0,0,0
XSC,1982,Inactive,0,0,0,0,0,0
XSC,1983,Inactive,0,0,0,0,0,0
XSC,1984,Active,0,1,1,0,0,2
XSC,1985,Active,0,0,0,0,0,0
XSC,1986,Active,0,0,1,0,0,1
XSC,1987,Active,0,0,0,0,0,0
XSC,1988,Active,0,0,2,0,0,2
XSC,1989,Active,0,0,0,0,0,0
XSC,1990,Active,1,0,2,0,0,3
XSC,1991,Active,0,1,0,0,0,1
XSC,1992,Active,1,0,1,0,0,2
XSC,1993,Active,0,0,0,0,0,0
XSC,1994,Active,0,1,3,0,0,4
XSC,1995,Active,0,0,2,0,0,2
XSC,1996,Active,0,0,1,1,0,2
XSC,1997,Active,0,0,4,0,0,4
XSC,1998,Active,0,0,2,0,0,2
XSC,1999,Active,0,0,0,0,0,0
XSC,2000,Active,0,0,4,0,0,4
XSC,2001,Active,0,0,0,0,0,0
XSC,2002,Active,0,0,0,0,0,0
XSC,2003,Active,0,1,2,0,0,3
XSC,2004,Active,2,0,1,0,0,3
XSC,2005,Active,0,0,1,0,0,1
XSC,2006,Active,0,0,2,1,0,3
XSC,2007,Active,0,1,4,1,0,6
XSC,2008,Active,0,0,4,0,0,4
XSC,2009,Active,0,0,2,0,0,2
XSC,2010,Active,0,0,7,1,0,8
XSC,2011,Active,0,0,9,0,0,9
XSC,2012,Active,0,2,7,0,0,9
XSC,2013,Active,0,0,2,1,0,3
XSC,2014,Active,1,0,1,0,0,2
XSC,2015,Active,0,1,8,0,0,9
XSC,2016,Active,0,1,6,0,0,7
XSC,2017,Active,3,1,4,0,0,8
YAVNE,1957,Inactive,0,0,0,0,0,0
YAVNE,1958,Inactive,0,0,0,0,0,0
YAVNE,1959,Inactive,0,0,0,0,0,0
YAVNE,1960,Inactive,0,0,0,0,0,0
YAVNE,1961,Inactive,0,0,0,0,0,0
YAVNE,1962,Inactive,0,0,0,0,0,0
YAVNE,1963,Inactive,0,0,0,0,0,0
YAVNE,1964,Inactive,0,0,0,0,0,0
YAVNE,1965,Inactive,0,0,0,0,0,0
YAVNE,1966,Inactive,0,0,0,0,0,0
YAVNE,1967,Inactive,0,0,0,0,0,0
YAVNE,1968,Inactive,0,0,0,0,0,0
YAVNE,1969,Inactive,0,0,0,0,0,0
YAVNE,1970,Inactive,0,0,0,0,0,0
YAVNE,1971,Inactive,0,0,0,0,0,0
YAVNE,1972,Inactive,0,0,0,0,0,0
YAVNE,1973,Inactive,0,0,0,0,0,0
YAVNE,1974,Inactive,0,0,0,0,0,0
YAVNE,1975,Inactive,0,0,0,0,0,0
YAVNE,1976,Inactive,0,0,0,0,0,0
YAVNE,1977,Inactive,0,0,0,0,0,0
YAVNE,1978,Inactive,0,0,0,0,0,0
YAVNE,1979,Inactive,0,0,0,0,0,0
YAVNE,1980,Inactive,0,0,0,0,0,0
YAVNE,1981,Inactive,0,0,0,0,0,0
YAVNE,1982,Inactive,0,0,0,0,0,0
YAVNE,1983,Inactive,0,0,0,0,0,0
YAVNE,1984,Inactive,0,0,0,0,0,0
YAVNE,1985,Inactive,0,0,0,0,0,0
YAVNE,1986,Inactive,0,0,0,0,0,0
YAVNE,1987,Inactive,0,0,0,0,0,0
YAVNE,1988,Active,1,0,0,0,0,1
YAVNE,1989,Active,0,0,0,0,0,0
YAVNE,1990,Active,1,0,0,0,0,1
YAVNE,1991,Active,0,0,0,0,0,0
YAVNE,1992,Active,0,0,0,0,0,0
YAVNE,1993,Active,0,0,0,0,0,0
YAVNE,1994,Active,0,0,0,0,0,0
YAVNE,1995,Active,1,0,0,0,0,1
YAVNE,1996,Inactive,0,0,0,0,0,0
YAVNE,1997,Inactive,0,0,0,0,0,0
YAVNE,1998,Inactive,0,0,0,0,0,0
YAVNE,1999,Inactive,0,0,0,0,0,0
YAVNE,2000,Inactive,0,0,0,0,0,0
YAVNE,2001,Inactive,0,0,0,0,0,0
YAVNE,2002,Inactive,0,0,0,0,1,1
YAVNE,2003,Inactive,0,0,0,0,0,0
YAVNE,2004,Inactive,0,0,0,0,0,0
YAVNE,2005,Inactive,0,0,0,0,0,0
YAVNE,2006,Inactive,0,0,0,0,0,0
YAVNE,2007,Inactive,0,0,0,0,1,1
YAVNE,2008,Inactive,0,0,0,0,0,0
YAVNE,2009,Inactive,0,0,0,0,0,0
YAVNE,2010,Inactive,0,0,0,0,1,1
YAVNE,2011,Inactive,0,0,0,0,0,0
YAVNE,2012,Inactive,0,0,0,0,0,0
YAVNE,2013,Inactive,0,0,0,0,0,0
YAVNE,2014,Inactive,0,0,0,0,1,1
YAVNE,2015,Inactive,0,0,0,0,0,0
YAVNE,2016,Inactive,0,0,0,0,1,1
YAVNE,2017,Inactive,0,0,0,0,0,0
YUN,1957,Inactive,0,0,0,0,0,0
YUN,1958,Inactive,0,0,0,0,0,0
YUN,1959,Inactive,0,0,0,0,0,0
YUN,1960,Inactive,0,0,0,0,0,0
YUN,1961,Inactive,0,0,0,0,0,0
YUN,1962,Inactive,0,0,0,0,0,0
YUN,1963,Inactive,0,0,0,0,0,0
YUN,1964,Inactive,0,0,0,0,0,0
YUN,1965,Inactive,0,0,0,0,0,0
YUN,1966,Inactive,0,0,0,0,0,0
YUN,1967,Inactive,0,0,0,0,0,0
YUN,1968,Inactive,0,0,0,0,0,0
YUN,1969,Inactive,0,0,0,0,0,0
YUN,1970,Inactive,0,0,0,0,0,0
YUN,1971,Inactive,0,0,0,0,0,0
YUN,1972,Inactive,0,0,0,0,0,0
YUN,1973,Inactive,0,0,0,0,0,0
YUN,1974,Inactive,0,0,0,0,0,0
YUN,1975,Inactive,0,0,0,0,0,0
YUN,1976,Inactive,0,0,0,0,0,0
YUN,1977,Inactive,0,0,0,0,0,0
YUN,1978,Inactive,0,0,0,0,0,0
YUN,1979,Inactive,0,0,0,0,0,0
YUN,1980,Inactive,0,0,0,0,0,0
YUN,1981,Inactive,0,0,0,0,0,0
YUN,1982,Inactive,0,0,0,0,0,0
YUN,1983,Inactive,0,0,0,0,0,0
YUN,1984,Inactive,0,0,0,0,0,0
YUN,1985,Inactive,0,0,0,0,0,0
YUN,1986,Inactive,0,0,0,0,0,0
YUN,1987,Inactive,0,0,0,0,0,0
YUN,1988,Inactive,0,0,0,0,0,0
YUN,1989,Inactive,0,0,0,0,0,0
YUN,1990,Inactive,0,0,0,0,0,0
YUN,1991,Inactive,0,0,0,0,0,0
YUN,1992,Inactive,0,0,0,0,0,0
YUN,1993,Inactive,0,0,0,0,0,0
YUN,1994,Inactive,0,0,0,0,0,0
YUN,1995,Inactive,0,0,0,0,0,0
YUN,1996,Inactive,0,0,0,0,0,0
YUN,1997,Inactive,0,0,0,0,0,0
YUN,1998,Inactive,0,0,0,0,0,0
YUN,1999,Inactive,0,0,0,0,0,0
YUN,2000,Inactive,0,0,0,0,0,0
YUN,2001,Inactive,0,0,0,0,0,0
YUN,2002,Inactive,0,0,0,0,0,0
YUN,2003,Inactive,0,0,0,0,0,0
YUN,2004,Inactive,0,0,0,0,0,0
YUN,2005,Inactive,0,0,0,0,0,0
YUN,2006,Inactive,0,0,0,0,0,0
YUN,2007,Inactive,0,0,0,0,0,0
YUN,2008,Inactive,0,0,0,0,0,0
YUN,2009,Inactive,0,0,0,0,0,0
YUN,2010,Inactive,0,0,0,0,0,0
YUN,2011,Inactive,0,0,0,0,0,0
YUN,2012,Active,1,0,0,0,0,1
YUN,2013,Active,0,0,0,0,0,0
YUN,2014,Active,0,0,0,0,0,0
YUN,2015,Active,0,0,0,0,0,0
YUN,2016,Active,1,0,0,0,0,1
YUN,2017,Active,0,0,0,0,0,0